Date,Kind,Model,Max Mode,Input (w/ Cache Write),Input (w/o Cache Write),Cache Read,Output Tokens,Total Tokens,Cost
"2025-10-28T21:41:47.812Z","Included","claude-4.5-sonnet-thinking","No","1785","398","604494","499","607176","0.46"
"2025-10-28T21:40:34.343Z","Included","claude-4.5-sonnet-thinking","Yes","3735","10","600061","822","604628","0.49"
"2025-10-28T21:40:06.983Z","Included","claude-4.5-sonnet-thinking","Yes","642","1053","600620","3437","605752","0.53"
"2025-10-28T21:38:29.419Z","Included","claude-4.5-sonnet-thinking","Yes","2685","212","596734","560","600191","0.47"
"2025-10-28T21:37:19.881Z","Included","claude-4.5-sonnet-thinking","No","652","384","599169","509","600714","0.45"
"2025-10-28T21:37:19.200Z","Included","claude-4.5-sonnet-thinking","Yes","0","0","0","0","0","0.00"
"2025-10-28T21:37:05.540Z","Included","claude-4.5-sonnet-thinking","Yes","1745","12","596734","224","598715","0.45"
"2025-10-28T21:37:05.101Z","Included","claude-4.5-sonnet-thinking","Yes","0","0","0","0","0","0.00"
"2025-10-28T21:36:41.051Z","Included","claude-4.5-sonnet-thinking","Yes","3912","844","594007","283","599046","0.47"
"2025-10-28T21:35:15.212Z","Included","claude-4.5-sonnet-thinking","No","3729","389","593508","647","598273","0.48"
"2025-10-28T21:35:13.101Z","Included","claude-4.5-sonnet-thinking","Yes","0","0","0","0","0","0.00"
"2025-10-28T21:35:11.719Z","Included","claude-4.5-sonnet-thinking","Yes","0","0","0","0","0","0.00"
"2025-10-28T21:35:11.064Z","Included","claude-4.5-sonnet-thinking","Yes","0","0","0","0","0","0.00"
"2025-10-28T21:34:49.726Z","Included","claude-4.5-sonnet-thinking","Yes","2465","1056","591547","1593","596661","0.49"
"2025-10-28T21:33:17.489Z","Included","claude-4.5-sonnet-thinking","Yes","0","0","0","0","0","0.00"
"2025-10-28T21:33:14.897Z","Included","claude-4.5-sonnet-thinking","Yes","0","0","0","0","0","0.00"
"2025-10-28T21:33:01.258Z","Included","claude-4.5-sonnet-thinking","Yes","3545","56","586812","1038","591451","0.48"
"2025-10-28T21:31:50.951Z","Included","claude-4.5-sonnet-thinking","Yes","0","0","0","0","0","0.00"
"2025-10-28T21:31:44.702Z","Included","claude-4.5-sonnet-thinking","Yes","0","0","0","0","0","0.00"
"2025-10-28T21:31:28.352Z","Included","claude-4.5-sonnet-thinking","Yes","7549","750","579263","1147","588709","0.52"
"2025-10-28T21:29:05.660Z","Included","claude-4.5-sonnet-thinking","No","575771","448","11547","487","588253","5.20"
"2025-10-28T21:29:00.045Z","Included","claude-4.5-sonnet-thinking","Yes","0","0","0","0","0","0.00"
"2025-10-28T21:28:38.775Z","Included","claude-4.5-sonnet-thinking","Yes","0","0","0","0","0","0.00"
"2025-10-28T21:28:20.464Z","Included","claude-4.5-sonnet-thinking","Yes","593","10","580503","2831","583937","0.50"
"2025-10-28T21:28:08.584Z","Errored, Not Charged","claude-4.5-sonnet-thinking","Yes","1240","11","579263","97","580611","0.43"
"2025-10-28T21:27:45.784Z","Included","claude-4.5-sonnet-thinking","Yes","568416","1847","12049","201","582513","5.14"
"2025-10-28T21:19:45.255Z","Included","claude-4.5-sonnet-thinking","No","3664","298","576174","474","580610","0.46"
"2025-10-28T21:19:43.189Z","Included","claude-4.5-sonnet-thinking","Yes","0","0","0","0","0","0.00"
"2025-10-28T21:19:31.281Z","Included","claude-4.5-sonnet-thinking","Yes","0","0","0","0","0","0.00"
"2025-10-28T21:19:16.145Z","Included","claude-4.5-sonnet-thinking","Yes","2742","873","573958","1726","579299","0.48"
"2025-10-28T21:15:40.689Z","Included","claude-4.5-sonnet-thinking","Yes","0","0","0","0","0","0.00"
"2025-10-28T21:15:38.217Z","Included","claude-4.5-sonnet-thinking","Yes","0","0","0","0","0","0.00"
"2025-10-28T21:15:15.270Z","Included","claude-4.5-sonnet-thinking","Yes","5090","67","567679","1065","573901","0.48"
"2025-10-28T21:12:17.393Z","Included","claude-4.5-sonnet-thinking","Yes","0","0","0","0","0","0.00"
"2025-10-28T21:12:16.142Z","Included","claude-4.5-sonnet-thinking","Yes","0","0","0","0","0","0.00"
"2025-10-28T21:12:09.340Z","Included","claude-4.5-sonnet-thinking","Yes","0","0","0","0","0","0.00"
"2025-10-28T21:11:53.337Z","Included","claude-4.5-sonnet-thinking","Yes","0","0","0","0","0","0.00"
"2025-10-28T21:11:36.549Z","Included","claude-4.5-sonnet-thinking","Yes","4988","1129","562691","384","569192","0.47"
"2025-10-28T21:07:28.369Z","Included","claude-4.5-sonnet-thinking","Yes","0","0","0","0","0","0.00"
"2025-10-28T21:07:24.383Z","Included","claude-4.5-sonnet-thinking","Yes","0","0","0","0","0","0.00"
"2025-10-28T21:07:12.550Z","Included","claude-4.5-sonnet-thinking","Yes","0","0","0","0","0","0.00"
"2025-10-28T21:06:57.784Z","Included","claude-4.5-sonnet-thinking","Yes","0","0","0","0","0","0.00"
"2025-10-28T21:06:36.744Z","Included","claude-4.5-sonnet-thinking","Yes","551844","1603","10847","273","564567","4.99"
"2025-10-28T21:04:58.448Z","Included","claude-4.5-sonnet-thinking","No","1009","612","562819","466","564906","0.43"
"2025-10-28T21:04:42.128Z","Included","claude-4.5-sonnet-thinking","Yes","329","10","561743","478","562560","0.42"
"2025-10-28T21:04:23.523Z","Included","claude-4.5-sonnet-thinking","Yes","5229","12","556514","172","561927","0.45"
"2025-10-28T21:04:22.970Z","Errored, Not Charged","claude-4.5-sonnet-thinking","Yes","0","0","0","0","0","0.00"
"2025-10-28T21:04:22.061Z","Included","claude-4.5-sonnet-thinking","Yes","0","0","0","0","0","0.00"
"2025-10-28T21:04:20.783Z","Included","claude-4.5-sonnet-thinking","Yes","0","0","0","0","0","0.00"
"2025-10-28T21:04:18.969Z","Included","claude-4.5-sonnet-thinking","Yes","0","0","0","0","0","0.00"
"2025-10-28T21:04:17.735Z","Included","claude-4.5-sonnet-thinking","Yes","0","0","0","0","0","0.00"
"2025-10-28T21:04:16.585Z","Included","claude-4.5-sonnet-thinking","Yes","0","0","0","0","0","0.00"
"2025-10-28T21:04:09.855Z","Included","claude-4.5-sonnet-thinking","Yes","0","0","0","0","0","0.00"
"2025-10-28T21:03:43.587Z","Included","claude-4.5-sonnet-thinking","Yes","1112","11","555402","2335","558860","0.47"
"2025-10-28T21:03:30.311Z","Included","claude-4.5-sonnet-thinking","Yes","1654","13","553748","178","555593","0.42"
"2025-10-28T21:03:28.652Z","Included","claude-4.5-sonnet-thinking","Yes","0","0","0","0","0","0.00"
"2025-10-28T21:03:19.971Z","Included","claude-4.5-sonnet-thinking","Yes","0","0","0","0","0","0.00"
"2025-10-28T21:03:03.201Z","Included","claude-4.5-sonnet-thinking","Yes","1058","13","552690","963","554724","0.43"
"2025-10-28T21:03:02.187Z","Included","claude-4.5-sonnet-thinking","Yes","0","0","0","0","0","0.00"
"2025-10-28T21:02:38.319Z","Included","claude-4.5-sonnet-thinking","Yes","541843","906","12053","534","555336","4.90"
"2025-10-28T20:58:52.984Z","Included","claude-4.5-sonnet-thinking","Yes","0","0","0","0","0","0.00"
"2025-10-28T20:58:42.331Z","Included","claude-4.5-sonnet-thinking","Yes","0","0","0","0","0","0.00"
"2025-10-28T20:58:19.624Z","Included","claude-4.5-sonnet-thinking","Yes","0","0","0","0","0","0.00"
"2025-10-28T20:58:19.045Z","Errored, Not Charged","claude-4.5-sonnet-thinking","Yes","0","0","0","0","0","0.00"
"2025-10-28T20:58:17.713Z","Included","claude-4.5-sonnet-thinking","Yes","0","0","0","0","0","0.00"
"2025-10-28T20:58:11.971Z","Included","claude-4.5-sonnet-thinking","Yes","0","0","0","0","0","0.00"
"2025-10-28T20:57:56.590Z","Included","claude-4.5-sonnet-thinking","Yes","0","0","0","0","0","0.00"
"2025-10-28T20:57:50.943Z","Included","claude-4.5-sonnet-thinking","Yes","0","0","0","0","0","0.00"
"2025-10-28T20:57:35.896Z","Included","claude-4.5-sonnet-thinking","Yes","0","0","0","0","0","0.00"
"2025-10-28T20:57:35.830Z","Included","claude-4.5-sonnet-thinking","Yes","0","0","0","0","0","0.00"
"2025-10-28T20:57:35.752Z","Included","claude-4.5-sonnet-thinking","Yes","0","0","0","0","0","0.00"
"2025-10-28T20:57:02.633Z","Included","claude-4.5-sonnet-thinking","Yes","4026","77","542038","621","546762","0.44"
"2025-10-28T20:55:07.802Z","Included","claude-4.5-sonnet-thinking","No","3712","351","542720","531","547314","0.44"
"2025-10-28T20:54:51.367Z","Included","claude-4.5-sonnet-thinking","Yes","0","0","0","0","0","0.00"
"2025-10-28T20:54:46.786Z","Included","claude-4.5-sonnet-thinking","Yes","0","0","0","0","0","0.00"
"2025-10-28T20:54:21.876Z","Included","claude-4.5-sonnet-thinking","Yes","3064","803","540153","1731","545751","0.46"
"2025-10-28T20:52:21.680Z","Included","claude-4.5-sonnet-thinking","No","3037","315","539648","504","543504","0.43"
"2025-10-28T20:52:15.063Z","Included","claude-4.5-sonnet-thinking","Yes","0","0","0","0","0","0.00"
"2025-10-28T20:51:00.956Z","Included","claude-4.5-sonnet-thinking","Yes","528127","914","12048","1453","542542","4.80"
"2025-10-28T20:43:04.323Z","Included","claude-4.5-sonnet-thinking","No","2663","350","536755","676","540444","0.43"
"2025-10-28T20:42:43.706Z","Included","claude-4.5-sonnet-thinking","Yes","0","0","0","0","0","0.00"
"2025-10-28T20:42:27.466Z","Included","claude-4.5-sonnet-thinking","Yes","492","784","536756","1265","539297","0.42"
"2025-10-28T20:41:42.966Z","Included","claude-4.5-sonnet-thinking","No","524731","1108","12698","753","539290","4.75"
"2025-10-28T20:34:01.386Z","Included","claude-4.5-sonnet-thinking","No","0","7962","0","160","8122","0.02"
"2025-10-28T20:34:00.180Z","Errored, Not Charged","claude-4.5-sonnet-thinking","Yes","0","0","0","0","0","0.00"
"2025-10-28T20:33:36.143Z","Included","claude-4.5-sonnet-thinking","Yes","523883","830","12031","520","537264","4.74"
"2025-10-28T19:29:07.998Z","Included","claude-4.5-sonnet-thinking","No","5809","347","529263","570","535989","0.45"
"2025-10-28T19:28:56.765Z","Included","claude-4.5-sonnet-thinking","Yes","0","0","0","0","0","0.00"
"2025-10-28T19:28:51.689Z","Included","claude-4.5-sonnet-thinking","Yes","0","0","0","0","0","0.00"
"2025-10-28T19:28:43.146Z","Included","claude-4.5-sonnet-thinking","Yes","0","0","0","0","0","0.00"
"2025-10-28T19:28:32.391Z","Included","claude-4.5-sonnet-thinking","Yes","3568","802","525686","2851","532907","0.49"
"2025-10-28T19:27:49.971Z","Included","claude-4.5-sonnet-thinking","No","3277","358","525700","677","530012","0.43"
"2025-10-28T19:27:38.183Z","Included","claude-4.5-sonnet-thinking","Yes","0","0","0","0","0","0.00"
"2025-10-28T19:27:07.621Z","Included","claude-4.5-sonnet-thinking","Yes","514169","868","12039","1421","528497","4.67"
"2025-10-28T19:16:18.153Z","Included","claude-4.5-sonnet-thinking","No","2671","324","522855","460","526310","0.41"
"2025-10-28T19:16:12.638Z","Included","claude-4.5-sonnet-thinking","Yes","0","0","0","0","0","0.00"
"2025-10-28T19:15:52.872Z","Included","claude-4.5-sonnet-thinking","Yes","3602","833","519762","1231","525428","0.44"
"2025-10-28T19:12:28.935Z","Included","claude-4.5-sonnet-thinking","No","3337","312","519246","499","523394","0.42"
"2025-10-28T19:12:19.877Z","Included","claude-4.5-sonnet-thinking","Yes","0","0","0","0","0","0.00"
"2025-10-28T19:12:18.040Z","Included","claude-4.5-sonnet-thinking","Yes","0","0","0","0","0","0.00"
"2025-10-28T19:11:55.234Z","Included","claude-4.5-sonnet-thinking","Yes","7454","828","512305","1401","521988","0.47"
"2025-10-28T19:09:44.831Z","Included","claude-4.5-sonnet-thinking","No","7294","386","511812","545","520037","0.45"
"2025-10-28T19:09:40.322Z","Included","claude-4.5-sonnet-thinking","Yes","0","0","0","0","0","0.00"
"2025-10-28T19:09:32.193Z","Included","claude-4.5-sonnet-thinking","Yes","0","0","0","0","0","0.00"
"2025-10-28T19:09:22.873Z","Included","claude-4.5-sonnet-thinking","Yes","0","0","0","0","0","0.00"
"2025-10-28T19:08:58.433Z","Included","claude-4.5-sonnet-thinking","Yes","6006","1962","506298","3125","517391","0.51"
"2025-10-28T19:05:55.450Z","Included","claude-4.5-sonnet-thinking","No","1135","345","510425","402","512307","0.39"
"2025-10-28T19:05:21.603Z","Included","claude-4.5-sonnet-thinking","Yes","4628","10","505117","323","510078","0.41"
"2025-10-28T19:05:01.523Z","Included","claude-4.5-sonnet-thinking","Yes","494270","2011","12044","2017","510342","4.52"
"2025-10-28T18:56:56.232Z","Errored, Not Charged","claude-4.5-sonnet-thinking","No","1847","424","503823","441","506535","0.39"
"2025-10-28T18:56:06.393Z","Included","claude-4.5-sonnet-thinking","Yes","4715","11","498408","1227","504361","0.43"
"2025-10-28T18:55:50.925Z","Included","claude-4.5-sonnet-thinking","Yes","3163","13","495245","2702","501123","0.46"
"2025-10-28T18:55:48.552Z","Included","claude-4.5-sonnet-thinking","Yes","0","0","0","0","0","0.00"
"2025-10-28T18:55:39.991Z","Included","claude-4.5-sonnet-thinking","Yes","0","0","0","0","0","0.00"
"2025-10-28T18:55:24.637Z","Included","claude-4.5-sonnet-thinking","Yes","3553","952","492897","1529","498931","0.43"
"2025-10-28T18:52:00.204Z","Included","claude-4.5-sonnet-thinking","No","3242","328","492366","535","496471","0.40"
"2025-10-28T18:51:54.056Z","Included","claude-4.5-sonnet-thinking","Yes","0","0","0","0","0","0.00"
"2025-10-28T18:51:37.223Z","Included","claude-4.5-sonnet-thinking","Yes","8160","1153","484717","1686","495716","0.47"
"2025-10-28T18:48:05.501Z","Included","claude-4.5-sonnet-thinking","No","4024","465","488162","573","493224","0.40"
"2025-10-28T18:47:59.205Z","Included","claude-4.5-sonnet-thinking","Yes","0","0","0","0","0","0.00"
"2025-10-28T18:47:54.616Z","Included","claude-4.5-sonnet-thinking","Yes","0","0","0","0","0","0.00"
"2025-10-28T18:47:40.937Z","Included","claude-4.5-sonnet-thinking","Yes","3915","12","483532","2224","489683","0.44"
"2025-10-28T18:47:27.347Z","Included","claude-4.5-sonnet-thinking","Yes","4715","1945","480026","265","486951","0.40"
"2025-10-28T18:45:31.778Z","Included","claude-4.5-sonnet-thinking","No","4407","345","479493","561","484806","0.40"
"2025-10-28T18:45:09.273Z","Included","claude-4.5-sonnet-thinking","Yes","0","0","0","0","0","0.00"
"2025-10-28T18:44:55.920Z","Included","claude-4.5-sonnet-thinking","Yes","5805","877","474203","2471","483356","0.46"
"2025-10-28T18:41:43.525Z","Included","claude-4.5-sonnet-thinking","No","5569","270","473665","491","479995","0.40"
"2025-10-28T18:41:23.714Z","Included","claude-4.5-sonnet-thinking","Yes","0","0","0","0","0","0.00"
"2025-10-28T18:41:07.353Z","Included","claude-4.5-sonnet-thinking","Yes","13533","2342","460657","2379","478911","0.53"
"2025-10-28T18:36:31.457Z","Included","claude-4.5-sonnet-thinking","No","1886","489","471621","516","474512","0.37"
"2025-10-28T18:35:45.427Z","Included","claude-4.5-sonnet-thinking","Yes","11426","14","459479","1187","472106","0.47"
"2025-10-28T18:35:20.679Z","Included","claude-4.5-sonnet-thinking","Yes","0","0","0","0","0","0.00"
"2025-10-28T18:35:01.704Z","Included","claude-4.5-sonnet-thinking","Yes","3476","1066","456691","6002","467235","0.52"
"2025-10-28T18:30:14.233Z","Included","claude-4.5-sonnet-thinking","No","3296","252","456652","365","460565","0.37"
"2025-10-28T18:30:12.599Z","Included","claude-4.5-sonnet-thinking","Yes","0","0","0","0","0","0.00"
"2025-10-28T18:30:07.867Z","Included","claude-4.5-sonnet-thinking","Yes","0","0","0","0","0","0.00"
"2025-10-28T18:29:48.348Z","Included","claude-4.5-sonnet-thinking","Yes","5227","1175","451952","1622","459976","0.42"
"2025-10-28T18:27:45.220Z","Included","claude-4.5-sonnet-thinking","No","2747","352","453622","495","457216","0.36"
"2025-10-28T18:27:42.118Z","Included","claude-4.5-sonnet-thinking","Yes","0","0","0","0","0","0.00"
"2025-10-28T18:27:28.030Z","Included","claude-4.5-sonnet-thinking","Yes","2165","12","450776","1467","454420","0.38"
"2025-10-28T18:27:12.135Z","Included","claude-4.5-sonnet-thinking","Yes","7272","2410","444689","162","454533","0.40"
"2025-10-28T18:24:20.642Z","Included","claude-4.5-sonnet-thinking","No","6474","337","444794","433","452038","0.39"
"2025-10-28T18:24:12.147Z","Included","claude-4.5-sonnet-thinking","Yes","0","0","0","0","0","0.00"
"2025-10-28T18:23:48.674Z","Included","claude-4.5-sonnet-thinking","Yes","0","0","0","0","0","0.00"
"2025-10-28T18:23:36.552Z","Included","claude-4.5-sonnet-thinking","Yes","608","12","443504","3738","447862","0.43"
"2025-10-28T18:23:22.318Z","Included","claude-4.5-sonnet-thinking","Yes","10881","833","433807","202","445723","0.42"
"2025-10-28T18:20:36.145Z","Included","claude-4.5-sonnet-thinking","No","6324","436","437642","626","445028","0.39"
"2025-10-28T18:20:02.607Z","Included","claude-4.5-sonnet-thinking","Yes","0","0","0","0","0","0.00"
"2025-10-28T18:19:49.351Z","Included","claude-4.5-sonnet-thinking","Yes","4313","13","432623","3427","440376","0.44"
"2025-10-28T18:19:34.664Z","Included","claude-4.5-sonnet-thinking","Yes","421776","1868","12060","234","435938","3.82"
"2025-10-28T18:15:18.605Z","Included","claude-4.5-sonnet-thinking","No","10009","368","422944","584","433905","0.41"
"2025-10-28T18:15:17.326Z","Included","claude-4.5-sonnet-thinking","Yes","0","0","0","0","0","0.00"
"2025-10-28T18:14:53.267Z","Included","claude-4.5-sonnet-thinking","Yes","0","0","0","0","0","0.00"
"2025-10-28T18:14:20.016Z","Included","claude-4.5-sonnet-thinking","Yes","416637","900","12042","2541","432120","3.83"
"2025-10-28T18:12:19.149Z","Included","claude-4.5-sonnet-thinking","No","5023","354","422941","587","428905","0.37"
"2025-10-28T18:12:17.474Z","Included","claude-4.5-sonnet-thinking","Yes","0","0","0","0","0","0.00"
"2025-10-28T18:12:12.459Z","Included","claude-4.5-sonnet-thinking","Yes","0","0","0","0","0","0.00"
"2025-10-28T18:12:09.307Z","Errored, Not Charged","claude-4.5-sonnet-thinking","Yes","0","0","0","0","0","0.00"
"2025-10-28T18:12:04.870Z","Included","claude-4.5-sonnet-thinking","Yes","0","0","0","0","0","0.00"
"2025-10-28T18:11:59.827Z","Included","claude-4.5-sonnet-thinking","Yes","0","0","0","0","0","0.00"
"2025-10-28T18:11:44.316Z","Included","claude-4.5-sonnet-thinking","Yes","9323","826","414124","2750","427023","0.46"
"2025-10-28T18:10:19.568Z","Included","claude-4.5-sonnet-thinking","No","4735","454","417887","605","423681","0.36"
"2025-10-28T18:10:16.027Z","Included","claude-4.5-sonnet-thinking","Yes","0","0","0","0","0","0.00"
"2025-10-28T18:10:11.296Z","Included","claude-4.5-sonnet-thinking","Yes","0","0","0","0","0","0.00"
"2025-10-28T18:10:09.439Z","Included","claude-4.5-sonnet-thinking","Yes","0","0","0","0","0","0.00"
"2025-10-28T18:09:56.957Z","Included","claude-4.5-sonnet-thinking","Yes","0","0","0","0","0","0.00"
"2025-10-28T18:09:44.469Z","Included","claude-4.5-sonnet-thinking","Yes","4243","7","412936","2763","419949","0.41"
"2025-10-28T18:09:28.477Z","Included","claude-4.5-sonnet-thinking","Yes","6529","893","407606","269","415297","0.36"
"2025-10-28T18:07:53.324Z","Included","claude-4.5-sonnet-thinking","No","6306","391","407100","541","414338","0.36"
"2025-10-28T18:07:50.655Z","Included","claude-4.5-sonnet-thinking","Yes","0","0","0","0","0","0.00"
"2025-10-28T18:07:49.479Z","Included","claude-4.5-sonnet-thinking","Yes","0","0","0","0","0","0.00"
"2025-10-28T18:07:48.502Z","Included","claude-4.5-sonnet-thinking","Yes","0","0","0","0","0","0.00"
"2025-10-28T18:07:47.228Z","Included","claude-4.5-sonnet-thinking","Yes","0","0","0","0","0","0.00"
"2025-10-28T18:07:28.492Z","Included","claude-4.5-sonnet-thinking","Yes","0","0","0","0","0","0.00"
"2025-10-28T18:07:11.011Z","Included","claude-4.5-sonnet-thinking","Yes","12412","859","395187","3115","411573","0.48"
"2025-10-28T18:06:04.732Z","Included","claude-4.5-sonnet-thinking","No","1716","581","405272","676","408245","0.33"
"2025-10-28T18:04:44.548Z","Included","claude-4.5-sonnet-thinking","Yes","8096","9","396442","1023","405570","0.39"
"2025-10-28T18:04:27.992Z","Included","claude-4.5-sonnet-thinking","Yes","2447","10","393995","4256","400708","0.42"
"2025-10-28T18:04:11.897Z","Included","claude-4.5-sonnet-thinking","Yes","383148","1039","12070","332","396589","3.47"
"2025-10-28T17:58:28.360Z","Included","claude-4.5-sonnet-thinking","No","10577","1301","383043","598","395519","0.39"
"2025-10-28T17:58:16.351Z","Included","claude-4.5-sonnet-thinking","Yes","0","0","0","0","0","0.00"
"2025-10-28T17:57:40.439Z","Included","claude-4.5-sonnet-thinking","Yes","0","0","0","0","0","0.00"
"2025-10-28T17:57:34.775Z","Included","claude-4.5-sonnet-thinking","Yes","0","0","0","0","0","0.00"
"2025-10-28T17:57:23.704Z","Included","claude-4.5-sonnet-thinking","Yes","2692","948","381556","6088","391284","0.46"
"2025-10-28T17:55:38.614Z","Included","claude-4.5-sonnet-thinking","No","2492","252","381002","383","384129","0.31"
"2025-10-28T17:55:28.530Z","Included","claude-4.5-sonnet-thinking","Yes","0","0","0","0","0","0.00"
"2025-10-28T17:55:16.239Z","Included","claude-4.5-sonnet-thinking","Yes","6221","839","375318","1484","383862","0.37"
"2025-10-28T17:51:51.236Z","Included","claude-4.5-sonnet-thinking","No","3785","470","376984","853","382092","0.33"
"2025-10-28T17:51:47.188Z","Included","claude-4.5-sonnet-thinking","Yes","0","0","0","0","0","0.00"
"2025-10-28T17:51:45.151Z","Included","claude-4.5-sonnet-thinking","Yes","0","0","0","0","0","0.00"
"2025-10-28T17:51:40.849Z","Included","claude-4.5-sonnet-thinking","Yes","0","0","0","0","0","0.00"
"2025-10-28T17:51:20.074Z","Included","claude-4.5-sonnet-thinking","Yes","2143","9","374130","1951","378233","0.34"
"2025-10-28T17:51:10.814Z","Included","claude-4.5-sonnet-thinking","Yes","0","849","375317","1194","377360","0.30"
"2025-10-28T17:50:34.979Z","Included","claude-4.5-sonnet-thinking","No","0","758","1181","19","1958","0.000"
"2025-10-28T17:48:33.069Z","Included","claude-4.5-sonnet-thinking","No","7625","583","366769","951","375928","0.36"
"2025-10-28T17:47:59.489Z","Included","claude-4.5-sonnet-thinking","Yes","0","0","0","0","0","0.00"
"2025-10-28T17:47:43.498Z","Included","claude-4.5-sonnet-thinking","Yes","10233","1223","357063","4460","372979","0.47"
"2025-10-28T17:44:46.263Z","Included","claude-4.5-sonnet-thinking","No","5774","518","360627","909","367828","0.34"
"2025-10-28T17:44:21.318Z","Included","claude-4.5-sonnet-thinking","Yes","0","0","0","0","0","0.00"
"2025-10-28T17:44:02.797Z","Included","claude-4.5-sonnet-thinking","Yes","4098","11","355812","3393","363314","0.38"
"2025-10-28T17:43:59.189Z","Included","claude-4.5-sonnet-thinking","Yes","0","0","0","0","0","0.00"
"2025-10-28T17:43:49.164Z","Included","claude-4.5-sonnet-thinking","Yes","0","0","0","0","0","0.00"
"2025-10-28T17:43:33.774Z","Included","claude-4.5-sonnet-thinking","Yes","5552","828","351443","2197","360020","0.36"
"2025-10-28T17:42:19.563Z","Included","claude-4.5-sonnet-thinking","No","3636","452","352917","515","357520","0.30"
"2025-10-28T17:42:13.859Z","Included","claude-4.5-sonnet-thinking","Yes","0","0","0","0","0","0.00"
"2025-10-28T17:42:12.314Z","Included","claude-4.5-sonnet-thinking","Yes","0","0","0","0","0","0.00"
"2025-10-28T17:41:57.790Z","Included","claude-4.5-sonnet-thinking","Yes","1951","10","350260","2148","354369","0.33"
"2025-10-28T17:41:43.708Z","Included","claude-4.5-sonnet-thinking","Yes","1233","1938","350211","434","353816","0.28"
"2025-10-28T17:39:35.582Z","Included","claude-4.5-sonnet-thinking","No","674","448","349737","613","351472","0.27"
"2025-10-28T17:39:27.826Z","Included","claude-4.5-sonnet-thinking","Yes","2480","828","347729","201","351238","0.28"
"2025-10-28T17:38:32.985Z","Included","claude-4.5-sonnet-thinking","No","2147","327","347224","455","350153","0.28"
"2025-10-28T17:38:30.635Z","Included","claude-4.5-sonnet-thinking","Yes","0","0","0","0","0","0.00"
"2025-10-28T17:38:18.364Z","Included","claude-4.5-sonnet-thinking","Yes","3054","812","344164","1186","349216","0.31"
"2025-10-28T17:37:37.945Z","Included","claude-4.5-sonnet-thinking","No","2780","379","344185","481","347825","0.29"
"2025-10-28T17:37:36.244Z","Included","claude-4.5-sonnet-thinking","Yes","0","0","0","0","0","0.00"
"2025-10-28T17:37:34.759Z","Included","claude-4.5-sonnet-thinking","Yes","0","0","0","0","0","0.00"
"2025-10-28T17:37:20.716Z","Included","claude-4.5-sonnet-thinking","Yes","341","875","344347","1494","347057","0.29"
"2025-10-28T17:36:31.486Z","Included","claude-4.5-sonnet-thinking","No","3002","1114","341989","488","346593","0.29"
"2025-10-28T17:35:28.181Z","Included","claude-4.5-sonnet-thinking","No","2673","366","340839","469","344347","0.28"
"2025-10-28T17:35:22.921Z","Included","claude-4.5-sonnet-thinking","Yes","0","0","0","0","0","0.00"
"2025-10-28T17:35:20.135Z","Included","claude-4.5-sonnet-thinking","Yes","0","0","0","0","0","0.00"
"2025-10-28T17:35:11.027Z","Included","claude-4.5-sonnet-thinking","Yes","3906","901","337441","1416","343664","0.32"
"2025-10-28T17:31:02.130Z","Included","claude-4.5-sonnet-thinking","No","3662","277","336901","407","341247","0.29"
"2025-10-28T17:30:50.232Z","Included","claude-4.5-sonnet-thinking","Yes","0","0","0","0","0","0.00"
"2025-10-28T17:30:42.143Z","Included","claude-4.5-sonnet-thinking","Yes","2710","802","334204","2084","339800","0.32"
"2025-10-28T17:30:01.147Z","Included","claude-4.5-sonnet-thinking","No","2539","275","334194","397","337405","0.27"
"2025-10-28T17:29:58.120Z","Included","claude-4.5-sonnet-thinking","Yes","0","0","0","0","0","0.00"
"2025-10-28T17:29:47.412Z","Included","claude-4.5-sonnet-thinking","Yes","2205","838","332514","1434","336991","0.30"
"2025-10-28T17:29:08.400Z","Included","claude-4.5-sonnet-thinking","No","1973","258","331981","304","334516","0.26"
"2025-10-28T17:29:05.832Z","Included","claude-4.5-sonnet-thinking","Yes","0","0","0","0","0","0.00"
"2025-10-28T17:28:59.783Z","Included","claude-4.5-sonnet-thinking","Yes","2258","805","329741","1097","333901","0.29"
"2025-10-28T17:28:22.565Z","Included","claude-4.5-sonnet-thinking","No","2057","242","329718","281","332298","0.26"
"2025-10-28T17:28:20.685Z","Included","claude-4.5-sonnet-thinking","Yes","0","0","0","0","0","0.00"
"2025-10-28T17:28:14.318Z","Included","claude-4.5-sonnet-thinking","Yes","2169","842","328085","1112","332208","0.29"
"2025-10-28T17:27:19.888Z","Included","claude-4.5-sonnet-thinking","No","1984","216","327535","276","330011","0.26"
"2025-10-28T17:27:17.091Z","Included","claude-4.5-sonnet-thinking","Yes","0","0","0","0","0","0.00"
"2025-10-28T17:27:04.646Z","Included","claude-4.5-sonnet-thinking","Yes","7609","830","320478","1118","330035","0.33"
"2025-10-28T17:26:26.688Z","Included","claude-4.5-sonnet-thinking","No","7367","403","319988","464","328222","0.31"
"2025-10-28T17:26:25.256Z","Included","claude-4.5-sonnet-thinking","Yes","0","0","0","0","0","0.00"
"2025-10-28T17:26:18.938Z","Included","claude-4.5-sonnet-thinking","Yes","0","0","0","0","0","0.00"
"2025-10-28T17:25:54.680Z","Included","claude-4.5-sonnet-thinking","Yes","0","0","0","0","0","0.00"
"2025-10-28T17:25:52.323Z","Included","claude-4.5-sonnet-thinking","Yes","0","0","0","0","0","0.00"
"2025-10-28T17:25:42.408Z","Included","claude-4.5-sonnet-thinking","Yes","1409","789","319060","4159","325417","0.35"
"2025-10-28T17:23:37.860Z","Included","claude-4.5-sonnet-thinking","No","624","745","318643","1471","321483","0.27"
"2025-10-28T17:23:27.090Z","Included","claude-4.5-sonnet-thinking","Yes","11397","873","307679","230","320179","0.33"
"2025-10-28T17:20:51.246Z","Included","claude-4.5-sonnet-thinking","No","3522","308","315011","383","319224","0.27"
"2025-10-28T17:20:40.261Z","Included","claude-4.5-sonnet-thinking","Yes","1477","12","312866","1851","316206","0.29"
"2025-10-28T17:20:19.417Z","Included","claude-4.5-sonnet-thinking","Yes","6379","13","306487","181","313060","0.28"
"2025-10-28T17:19:50.510Z","Included","claude-4.5-sonnet-thinking","Yes","0","0","0","0","0","0.00"
"2025-10-28T17:18:45.156Z","Included","claude-4.5-sonnet-thinking","Yes","295640","1816","12032","3504","312992","2.77"
"2025-10-28T17:08:32.474Z","Included","claude-4.5-sonnet-thinking","No","6185","218","300769","394","307566","0.28"
"2025-10-28T17:08:03.556Z","Included","claude-4.5-sonnet-thinking","Yes","0","0","0","0","0","0.00"
"2025-10-28T17:07:55.720Z","Included","claude-4.5-sonnet-thinking","Yes","5781","804","295530","3483","305598","0.36"
"2025-10-28T17:06:13.376Z","Included","claude-4.5-sonnet-thinking","No","5434","420","295046","725","301625","0.28"
"2025-10-28T17:05:45.624Z","Included","claude-4.5-sonnet-thinking","Yes","0","0","0","0","0","0.00"
"2025-10-28T17:05:32.852Z","Included","claude-4.5-sonnet-thinking","Yes","5881","886","289658","3510","299935","0.36"
"2025-10-28T17:02:23.934Z","Included","claude-4.5-sonnet-thinking","No","5711","325","289145","537","295718","0.27"
"2025-10-28T17:02:17.149Z","Included","claude-4.5-sonnet-thinking","Yes","0","0","0","0","0","0.00"
"2025-10-28T17:02:04.090Z","Included","claude-4.5-sonnet-thinking","Yes","0","0","0","0","0","0.00"
"2025-10-28T17:02:01.554Z","Included","claude-4.5-sonnet-thinking","Yes","0","0","0","0","0","0.00"
"2025-10-28T17:01:48.089Z","Included","claude-4.5-sonnet-thinking","Yes","7337","839","282316","3245","293737","0.36"
"2025-10-28T17:00:37.473Z","Included","claude-4.5-sonnet-thinking","No","6975","383","281824","589","289771","0.28"
"2025-10-28T17:00:36.349Z","Included","claude-4.5-sonnet-thinking","Yes","0","0","0","0","0","0.00"
"2025-10-28T17:00:29.741Z","Included","claude-4.5-sonnet-thinking","Yes","0","0","0","0","0","0.00"
"2025-10-28T17:00:16.686Z","Included","claude-4.5-sonnet-thinking","Yes","0","0","0","0","0","0.00"
"2025-10-28T17:00:13.270Z","Included","claude-4.5-sonnet-thinking","Yes","0","0","0","0","0","0.00"
"2025-10-28T17:00:03.034Z","Included","claude-4.5-sonnet-thinking","Yes","9747","1951","272576","3179","287453","0.38"
"2025-10-28T16:58:18.742Z","Included","claude-4.5-sonnet-thinking","No","7929","408","273752","727","282816","0.29"
"2025-10-28T16:58:10.097Z","Included","claude-4.5-sonnet-thinking","Yes","0","0","0","0","0","0.00"
"2025-10-28T16:57:48.213Z","Included","claude-4.5-sonnet-thinking","Yes","0","0","0","0","0","0.00"
"2025-10-28T16:57:43.219Z","Included","claude-4.5-sonnet-thinking","Yes","0","0","0","0","0","0.00"
"2025-10-28T16:57:34.350Z","Included","claude-4.5-sonnet-thinking","Yes","1670","12","271386","4553","277621","0.33"
"2025-10-28T16:57:22.821Z","Included","claude-4.5-sonnet-thinking","Yes","3207","857","269367","310","273741","0.23"
"2025-10-28T16:56:11.584Z","Included","claude-4.5-sonnet-thinking","No","2153","205","269753","260","272371","0.22"
"2025-10-28T16:56:06.068Z","Included","claude-4.5-sonnet-thinking","Yes","0","0","0","0","0","0.00"
"2025-10-28T16:55:59.419Z","Included","claude-4.5-sonnet-thinking","Yes","940","12","268179","1300","270431","0.24"
"2025-10-28T16:55:53.230Z","Included","claude-4.5-sonnet-thinking","Yes","3808","820","265552","188","270368","0.23"
"2025-10-28T16:55:23.436Z","Included","claude-4.5-sonnet-thinking","No","3729","212","265006","309","269256","0.23"
"2025-10-28T16:55:11.268Z","Included","claude-4.5-sonnet-thinking","Yes","0","0","0","0","0","0.00"
"2025-10-28T16:55:04.179Z","Included","claude-4.5-sonnet-thinking","Yes","3782","855","261776","2118","268531","0.28"
"2025-10-28T16:54:29.204Z","Included","claude-4.5-sonnet-thinking","No","3595","224","261227","331","265377","0.23"
"2025-10-28T16:54:15.582Z","Included","claude-4.5-sonnet-thinking","Yes","0","0","0","0","0","0.00"
"2025-10-28T16:54:09.302Z","Included","claude-4.5-sonnet-thinking","Yes","6523","835","255249","2081","264688","0.30"
"2025-10-28T16:50:27.149Z","Included","claude-4.5-sonnet-thinking","No","6408","321","254738","638","262105","0.26"
"2025-10-28T16:49:54.977Z","Included","claude-4.5-sonnet-thinking","Yes","0","0","0","0","0","0.00"
"2025-10-28T16:49:39.760Z","Included","claude-4.5-sonnet-thinking","Yes","5794","1425","249451","3528","260198","0.33"
"2025-10-28T16:48:29.566Z","Included","claude-4.5-sonnet-thinking","No","5776","293","248932","441","255442","0.24"
"2025-10-28T16:47:59.283Z","Included","claude-4.5-sonnet-thinking","Yes","0","0","0","0","0","0.00"
"2025-10-28T16:47:45.771Z","Included","claude-4.5-sonnet-thinking","Yes","6123","902","243343","3555","253923","0.33"
"2025-10-28T16:45:35.304Z","Included","claude-4.5-sonnet-thinking","No","5947","311","242815","523","249596","0.24"
"2025-10-28T16:45:06.919Z","Included","claude-4.5-sonnet-thinking","Yes","0","0","0","0","0","0.00"
"2025-10-28T16:44:57.262Z","Included","claude-4.5-sonnet-thinking","Yes","4586","1115","238744","3446","247891","0.31"
"2025-10-28T16:42:58.454Z","Included","claude-4.5-sonnet-thinking","No","4472","193","238191","327","243183","0.22"
"2025-10-28T16:42:48.610Z","Included","claude-4.5-sonnet-thinking","Yes","8561","805","230181","2649","242196","0.31"
"2025-10-28T16:41:16.170Z","Included","claude-4.5-sonnet-thinking","No","1943","357","236341","579","239220","0.20"
"2025-10-28T16:41:13.448Z","Included","claude-4.5-sonnet-thinking","Yes","0","0","0","0","0","0.00"
"2025-10-28T16:40:38.754Z","Included","claude-4.5-sonnet-thinking","Yes","4231","12","231430","1152","236825","0.24"
"2025-10-28T16:40:27.971Z","Included","claude-4.5-sonnet-thinking","Yes","2428","13","229002","2595","234038","0.26"
"2025-10-28T16:40:19.718Z","Included","claude-4.5-sonnet-thinking","Yes","2842","1394","227344","244","231824","0.20"
"2025-10-28T16:39:06.700Z","Included","claude-4.5-sonnet-thinking","No","2755","1032","226160","540","230487","0.20"
"2025-10-28T16:38:58.960Z","Included","claude-4.5-sonnet-thinking","Yes","0","0","0","0","0","0.00"
"2025-10-28T16:38:43.664Z","Included","claude-4.5-sonnet-thinking","Yes","8709","868","218646","1632","229855","0.28"
"2025-10-28T16:37:36.769Z","Included","claude-4.5-sonnet-thinking","No","2352","441","224303","517","227613","0.20"
"2025-10-28T16:37:29.909Z","Included","claude-4.5-sonnet-thinking","Yes","0","0","0","0","0","0.00"
"2025-10-28T16:37:14.026Z","Included","claude-4.5-sonnet-thinking","Yes","2176","11","221425","1251","224863","0.21"
"2025-10-28T16:37:05.131Z","Included","claude-4.5-sonnet-thinking","Yes","3974","12","217451","1252","222689","0.23"
"2025-10-28T16:36:53.653Z","Included","claude-4.5-sonnet-thinking","Yes","206604","2011","12055","219","220889","1.88"
"2025-10-28T16:35:19.513Z","Included","claude-4.5-sonnet-thinking","No","3222","549","218127","641","222539","0.20"
"2025-10-28T16:34:54.843Z","Included","claude-4.5-sonnet-thinking","Yes","0","0","0","0","0","0.00"
"2025-10-28T16:34:40.303Z","Included","claude-4.5-sonnet-thinking","Yes","2622","9","214780","1949","219360","0.23"
"2025-10-28T16:34:31.128Z","Included","claude-4.5-sonnet-thinking","Yes","0","0","0","0","0","0.00"
"2025-10-28T16:34:02.570Z","Included","claude-4.5-sonnet-thinking","Yes","2795","8","211985","1461","216249","0.22"
"2025-10-28T16:33:53.688Z","Included","claude-4.5-sonnet-thinking","Yes","3298","9","208687","1497","213491","0.22"
"2025-10-28T16:33:46.546Z","Included","claude-4.5-sonnet-thinking","Yes","699","9","207988","168","208864","0.16"
"2025-10-28T16:33:37.582Z","Included","claude-4.5-sonnet-thinking","Yes","193819","822","15354","215","210210","1.76"
"2025-10-28T16:22:52.241Z","Included","claude-4.5-sonnet-thinking","No","1349","394","207477","553","209773","0.18"
"2025-10-28T16:22:36.146Z","Included","claude-4.5-sonnet-thinking","Yes","1539","9","205243","882","207673","0.19"
"2025-10-28T16:22:26.953Z","Included","claude-4.5-sonnet-thinking","Yes","1904","10","203339","912","206165","0.19"
"2025-10-28T16:22:17.925Z","Included","claude-4.5-sonnet-thinking","Yes","1296","11","202043","265","203615","0.16"
"2025-10-28T16:22:11.540Z","Included","claude-4.5-sonnet-thinking","Yes","3834","825","199392","234","204285","0.18"
"2025-10-28T16:20:08.685Z","Included","claude-4.5-sonnet-thinking","No","1332","359","201445","552","203688","0.17"
"2025-10-28T16:19:39.694Z","Included","claude-4.5-sonnet-thinking","Yes","2008","12","198755","863","201638","0.18"
"2025-10-28T16:19:30.256Z","Included","claude-4.5-sonnet-thinking","Yes","546","13","198209","1144","199912","0.09"
"2025-10-28T16:19:19.191Z","Included","claude-4.5-sonnet-thinking","Yes","184040","865","15376","247","200528","0.84"
"2025-10-28T16:17:55.520Z","Included","claude-4.5-sonnet-thinking","No","1870","667","197308","587","200432","0.09"
"2025-10-28T16:17:51.227Z","Included","claude-4.5-sonnet-thinking","Yes","0","0","0","0","0","0.00"
"2025-10-28T16:17:43.756Z","Included","claude-4.5-sonnet-thinking","Yes","1404","11","195154","1008","197577","0.09"
"2025-10-28T16:17:26.792Z","Included","claude-4.5-sonnet-thinking","Yes","1671","12","193483","127","195293","0.08"
"2025-10-28T16:17:20.879Z","Included","claude-4.5-sonnet-thinking","Yes","0","0","0","0","0","0.00"
"2025-10-28T16:17:12.896Z","Included","claude-4.5-sonnet-thinking","Yes","1802","12","191681","879","194374","0.09"
"2025-10-28T16:16:57.218Z","Included","claude-4.5-sonnet-thinking","Yes","0","0","0","0","0","0.00"
"2025-10-28T16:16:30.001Z","Errored, Not Charged","claude-4.5-sonnet-thinking","Yes","177511","11","14170","991","192683","0.82"
"2025-10-28T16:16:22.283Z","Included","claude-4.5-sonnet-thinking","Yes","1456","3","187096","1928","190483","0.11"
"2025-10-28T16:16:12.938Z","Included","claude-4.5-sonnet-thinking","Yes","3617","4","183479","140","187240","0.08"
"2025-10-28T16:15:54.835Z","Included","claude-4.5-sonnet-thinking","Yes","0","0","0","0","0","0.00"
"2025-10-28T16:15:40.056Z","Included","claude-4.5-sonnet-thinking","Yes","1164","3","182315","2226","185708","0.11"
"2025-10-28T16:15:31.638Z","Included","claude-4.5-sonnet-thinking","Yes","3307","866","180207","275","184655","0.08"
"2025-10-28T16:14:43.203Z","Included","claude-4.5-sonnet-thinking","No","1011","318","182194","451","183974","0.08"
"2025-10-28T16:14:32.565Z","Included","claude-4.5-sonnet-thinking","Yes","2513","5","179008","640","182166","0.09"
"2025-10-28T16:14:30.747Z","Included","claude-4.5-sonnet-thinking","Yes","0","0","0","0","0","0.00"
"2025-10-28T16:14:28.132Z","Included","claude-4.5-sonnet-thinking","Yes","0","0","0","0","0","0.00"
"2025-10-28T16:14:15.626Z","Included","claude-4.5-sonnet-thinking","Yes","3955","868","176247","1149","182219","0.10"
"2025-10-28T16:13:22.130Z","Included","claude-4.5-sonnet-thinking","No","3802","245","175695","454","180196","0.09"
"2025-10-28T16:13:07.813Z","Included","claude-4.5-sonnet-thinking","Yes","0","0","0","0","0","0.00"
"2025-10-28T16:13:01.589Z","Included","claude-4.5-sonnet-thinking","Yes","705","870","175538","2201","179314","0.11"
"2025-10-28T16:10:34.634Z","Included","claude-4.5-sonnet-thinking","No","678","98","174933","141","175850","0.07"
"2025-10-28T16:10:30.134Z","Included","claude-4.5-sonnet-thinking","Yes","1193","787","174334","332","176646","0.07"
"2025-10-28T16:08:32.542Z","Included","claude-4.5-sonnet-thinking","No","249","452","174624","549","175874","0.07"
"2025-10-28T16:08:26.324Z","Included","claude-4.5-sonnet-thinking","Yes","763","6","173155","182","174106","0.07"
"2025-10-28T16:08:20.141Z","Included","claude-4.5-sonnet-thinking","No","6049","1606","168421","244","176320","0.09"
"2025-10-28T16:06:39.984Z","Errored, Not Charged","claude-4.5-sonnet-thinking","No","158912","257","14821","335","174325","0.73"
"2025-10-28T16:06:35.050Z","Included","claude-4.5-sonnet-thinking","Yes","542","7","167366","2628","170543","0.11"
"2025-10-28T16:06:30.369Z","Included","claude-4.5-sonnet-thinking","Yes","260","7","167106","130","167503","0.06"
"2025-10-28T16:06:24.569Z","Included","claude-4.5-sonnet-thinking","Yes","3691","828","164603","200","169322","0.08"
"2025-10-28T16:05:15.718Z","Included","claude-4.5-sonnet-thinking","No","2201","268","165600","295","168364","0.07"
"2025-10-28T16:05:02.867Z","Included","claude-4.5-sonnet-thinking","Yes","925","6","164019","2118","167068","0.10"
"2025-10-28T16:04:57.083Z","Errored, Not Charged","claude-4.5-sonnet-thinking","Yes","203","7","163816","734","164760","0.07"
"2025-10-28T16:04:51.267Z","Included","claude-4.5-sonnet-thinking","Yes","401","8","163415","150","163974","0.06"
"2025-10-28T16:04:45.738Z","Included","claude-4.5-sonnet-thinking","Yes","3564","784","161029","221","165598","0.08"
"2025-10-28T16:03:57.474Z","Included","claude-4.5-sonnet-thinking","No","1032","327","163013","587","164959","0.07"
"2025-10-28T16:03:52.124Z","Included","claude-4.5-sonnet-thinking","Yes","312","8","162025","129","162474","0.06"
"2025-10-28T16:03:47.666Z","Included","claude-4.5-sonnet-thinking","Yes","2174","9","159851","140","162174","0.07"
"2025-10-28T16:03:37.262Z","Included","claude-4.5-sonnet-thinking","Yes","4159","2377","156873","334","163743","0.09"
"2025-10-28T16:02:27.966Z","Included","claude-4.5-sonnet-thinking","No","800","329","159888","442","161459","0.07"
"2025-10-28T16:02:17.471Z","Included","claude-4.5-sonnet-thinking","Yes","998","11","158222","485","159716","0.07"
"2025-10-28T16:02:10.673Z","Included","claude-4.5-sonnet-thinking","Yes","1013","12","157209","577","158811","0.07"
"2025-10-28T16:02:05.267Z","Included","claude-4.5-sonnet-thinking","Yes","1517","12","155692","178","157399","0.07"
"2025-10-28T16:01:56.172Z","Included","claude-4.5-sonnet-thinking","Yes","141523","903","15364","285","158075","0.65"
"2025-10-28T14:43:17.421Z","Included","claude-4.5-sonnet-thinking","No","856","212","152191","336","153595","0.06"
"2025-10-28T14:43:10.537Z","Included","claude-4.5-sonnet-thinking","Yes","1503","7","150053","658","152221","0.07"
"2025-10-28T14:43:05.008Z","Included","claude-4.5-sonnet-thinking","Yes","2031","7","148022","192","150252","0.07"
"2025-10-28T14:42:59.632Z","Included","claude-4.5-sonnet-thinking","Yes","2512","1951","146687","168","151318","0.07"
"2025-10-28T14:42:13.704Z","Included","claude-4.5-sonnet-thinking","No","2484","184","146138","249","149055","0.07"
"2025-10-28T14:42:03.464Z","Included","claude-4.5-sonnet-thinking","Yes","5177","2211","141511","968","149867","0.10"
"2025-10-28T14:39:20.072Z","Included","claude-4.5-sonnet-thinking","No","919","1137","145657","709","148422","0.07"
"2025-10-28T14:39:16.013Z","Included","claude-4.5-sonnet-thinking","Yes","568","7","144284","424","145283","0.06"
"2025-10-28T14:39:10.110Z","Included","claude-4.5-sonnet-thinking","Yes","182","8","144102","142","144434","0.06"
"2025-10-28T14:38:58.237Z","Included","claude-4.5-sonnet-thinking","Yes","1030","9","143072","135","144246","0.06"
"2025-10-28T14:38:51.289Z","Included","claude-4.5-sonnet-thinking","Yes","2739","10","140333","953","144035","0.08"
"2025-10-28T14:38:35.852Z","Included","claude-4.5-sonnet-thinking","No","129486","3740","12354","507","146087","0.60"
"2025-10-28T14:25:53.127Z","Included","claude-4.5-sonnet-thinking","No","1347","308","139664","291","141610","0.06"
"2025-10-28T14:25:37.140Z","Included","claude-4.5-sonnet-thinking","Yes","2942","12","136056","740","139750","0.08"
"2025-10-28T14:25:34.291Z","Included","claude-4.5-sonnet-thinking","Yes","0","0","0","0","0","0.00"
"2025-10-28T14:25:21.309Z","Included","claude-4.5-sonnet-thinking","Yes","0","0","0","0","0","0.00"
"2025-10-28T14:25:09.030Z","Errored, Not Charged","claude-4.5-sonnet-thinking","Yes","3253","12","132803","2546","138614","0.11"
"2025-10-28T14:24:47.530Z","Errored, Not Charged","claude-4.5-sonnet-thinking","Yes","0","0","0","0","0","0.00"
"2025-10-28T14:24:39.235Z","Included","claude-4.5-sonnet-thinking","Yes","121956","815","12030","3048","137849","0.61"
"2025-10-28T14:06:46.989Z","Included","claude-4.5-sonnet-thinking","No","1446","194","132087","229","133956","0.06"
"2025-10-28T14:06:42.753Z","Included","claude-4.5-sonnet-thinking","Yes","634","12","130827","695","132168","0.06"
"2025-10-28T14:06:38.112Z","Included","claude-4.5-sonnet-thinking","Yes","654","12","130173","139","130978","0.05"
"2025-10-28T14:06:30.800Z","Included","claude-4.5-sonnet-thinking","Yes","119326","853","12036","245","132460","0.55"
"2025-10-28T13:56:55.672Z","Included","claude-4.5-sonnet-thinking","No","3034","879","105293","23201","132407","0.47"
"2025-10-28T13:56:54.493Z","Included","claude-4.5-sonnet-thinking","Yes","0","0","0","0","0","0.00"
"2025-10-28T13:56:42.470Z","Included","claude-4.5-sonnet-thinking","Yes","93666","1154","12082","579","107481","0.44"
"2025-10-28T13:26:57.732Z","Included","claude-4.5-sonnet-thinking","No","2716","1449","82344","21158","107667","0.42"
"2025-10-28T13:26:36.739Z","Included","claude-4.5-sonnet-thinking","Yes","70652","3884","12338","905","87779","0.34"
"2025-10-28T13:24:22.536Z","Included","gpt-5-pro","No","0","2665","1491","20","4176","0.001"
"2025-10-28T12:55:29.330Z","Included","gpt-5-pro","No","0","56881","853","20360","78094","3.92"
"2025-10-28T12:53:17.825Z","Included","gpt-5-pro","Yes","0","54927","0","1042","55969","1.14"
"2025-10-28T12:49:03.065Z","Included","gpt-5-pro","Yes","0","54079","0","5424","59503","1.75"
"2025-10-28T12:49:03.025Z","Included","gpt-5-pro","Yes","0","0","0","0","0","0.00"
"2025-10-28T12:49:02.985Z","Included","gpt-5-pro","Yes","0","0","0","0","0","0.00"
"2025-10-28T12:49:02.944Z","Included","gpt-5-pro","Yes","0","0","0","0","0","0.00"
"2025-10-28T12:49:02.904Z","Included","gpt-5-pro","Yes","0","0","0","0","0","0.00"
"2025-10-28T12:46:14.882Z","Included","gpt-5-pro","Yes","0","11593","1515","1263","14371","0.33"
"2025-10-28T11:37:22.391Z","Included","gpt-5-pro","No","0","39565","778","508","40851","0.77"
"2025-10-28T11:34:02.466Z","Included","gpt-5-pro","Yes","0","38406","1173","2742","42321","1.07"
"2025-10-28T11:25:42.858Z","Included","gpt-5-pro","No","0","35787","833","8746","45366","1.88"
"2025-10-28T11:24:20.075Z","Included","gpt-5-pro","Yes","0","18439","1500","1962","21901","0.56"
"2025-10-28T09:04:17.973Z","Included","claude-4.5-sonnet-thinking","No","218795","1009","12671","360","232835","1.99"
"2025-10-28T08:52:04.717Z","Errored, Not Charged","claude-4.5-sonnet-thinking","Yes","0","0","0","0","0","0.00"
"2025-10-28T08:52:00.262Z","Included","claude-4.5-sonnet-thinking","Yes","218535","807","12025","179","231546","1.98"
"2025-10-28T08:43:50.792Z","Errored, Not Charged","claude-4.5-sonnet-thinking","Yes","0","0","0","0","0","0.00"
"2025-10-28T08:43:34.015Z","Included","claude-4.5-sonnet-thinking","Yes","0","0","0","0","0","0.00"
"2025-10-28T08:43:27.199Z","Included","claude-4.5-sonnet-thinking","Yes","1083","7","227189","840","229119","0.20"
"2025-10-28T08:43:25.844Z","Included","claude-4.5-sonnet-thinking","Yes","0","0","0","0","0","0.00"
"2025-10-28T08:43:19.861Z","Included","claude-4.5-sonnet-thinking","Yes","1236","7","225953","271","227467","0.18"
"2025-10-28T08:43:18.582Z","Included","claude-4.5-sonnet-thinking","Yes","0","0","0","0","0","0.00"
"2025-10-28T08:43:16.691Z","Included","claude-4.5-sonnet-thinking","Yes","0","0","0","0","0","0.00"
"2025-10-28T08:43:11.485Z","Included","claude-4.5-sonnet-thinking","Yes","2748","7","223205","374","226334","0.20"
"2025-10-28T08:43:11.425Z","Included","claude-4.5-sonnet-thinking","Yes","0","0","0","0","0","0.00"
"2025-10-28T08:43:11.330Z","Included","claude-4.5-sonnet-thinking","Yes","0","0","0","0","0","0.00"
"2025-10-28T08:43:11.094Z","Included","claude-4.5-sonnet-thinking","Yes","0","0","0","0","0","0.00"
"2025-10-28T08:43:02.691Z","Included","claude-4.5-sonnet-thinking","Yes","212358","1619","11506","255","225738","1.93"
"2025-10-28T08:31:43.998Z","Included","claude-4.5-sonnet-thinking","No","21728","1056","178469","23683","224936","0.59"
"2025-10-28T08:31:28.959Z","Included","claude-4.5-sonnet-thinking","Yes","1738","5","175933","90","177766","0.07"
"2025-10-28T08:31:24.891Z","Included","claude-4.5-sonnet-thinking","Yes","1306","7","174627","878","176818","0.08"
"2025-10-28T08:31:24.510Z","Included","claude-4.5-sonnet-thinking","Yes","0","0","0","0","0","0.00"
"2025-10-28T08:31:18.157Z","Included","claude-4.5-sonnet-thinking","Yes","0","0","0","0","0","0.00"
"2025-10-28T08:31:09.071Z","Included","claude-4.5-sonnet-thinking","Yes","1462","7","173165","339","174973","0.08"
"2025-10-28T08:31:07.757Z","Included","claude-4.5-sonnet-thinking","Yes","0","0","0","0","0","0.00"
"2025-10-28T08:31:02.509Z","Included","claude-4.5-sonnet-thinking","Yes","1224","6","171941","566","173737","0.08"
"2025-10-28T08:30:58.347Z","Included","claude-4.5-sonnet-thinking","Yes","681","7","171260","72","172020","0.07"
"2025-10-28T08:30:55.798Z","Included","claude-4.5-sonnet-thinking","Yes","0","0","0","0","0","0.00"
"2025-10-28T08:30:55.279Z","Included","claude-4.5-sonnet-thinking","Yes","0","0","0","0","0","0.00"
"2025-10-28T08:30:49.368Z","Included","claude-4.5-sonnet-thinking","Yes","6839","7","164421","283","171550","0.10"
"2025-10-28T08:30:49.332Z","Included","claude-4.5-sonnet-thinking","Yes","0","0","0","0","0","0.00"
"2025-10-28T08:30:47.428Z","Included","claude-4.5-sonnet-thinking","Yes","0","0","0","0","0","0.00"
"2025-10-28T08:30:38.837Z","Included","claude-4.5-sonnet-thinking","Yes","153574","1835","12056","374","167839","0.71"
"2025-10-28T08:17:18.492Z","Included","claude-4.5-sonnet-thinking","No","23470","980","173952","23620","222022","0.59"
"2025-10-28T08:17:02.469Z","Included","claude-4.5-sonnet-thinking","Yes","0","0","0","0","0","0.00"
"2025-10-28T08:16:55.145Z","Included","claude-4.5-sonnet-thinking","Yes","1234","7","171929","935","174105","0.08"
"2025-10-28T08:16:49.445Z","Included","claude-4.5-sonnet-thinking","Yes","0","0","0","0","0","0.00"
"2025-10-28T08:16:39.224Z","Included","claude-4.5-sonnet-thinking","Yes","1808","7","170121","636","172572","0.08"
"2025-10-28T08:16:37.976Z","Included","claude-4.5-sonnet-thinking","Yes","0","0","0","0","0","0.00"
"2025-10-28T08:16:35.634Z","Included","claude-4.5-sonnet-thinking","Yes","0","0","0","0","0","0.00"
"2025-10-28T08:16:29.213Z","Included","claude-4.5-sonnet-thinking","Yes","5700","7","164421","468","170596","0.09"
"2025-10-28T08:16:28.689Z","Included","claude-4.5-sonnet-thinking","Yes","0","0","0","0","0","0.00"
"2025-10-28T08:16:28.385Z","Included","claude-4.5-sonnet-thinking","Yes","0","0","0","0","0","0.00"
"2025-10-28T08:16:22.007Z","Included","claude-4.5-sonnet-thinking","Yes","28258","1232","137371","372","167233","0.18"
"2025-10-28T08:11:49.472Z","Included","claude-4.5-sonnet-thinking","No","21509","561","142980","594","165644","0.16"
"2025-10-28T08:11:36.519Z","Included","claude-4.5-sonnet-thinking","Yes","1896","7","140350","88","142341","0.06"
"2025-10-28T08:11:36.475Z","Included","claude-4.5-sonnet-thinking","Yes","0","0","0","0","0","0.00"
"2025-10-28T08:11:32.467Z","Included","claude-4.5-sonnet-thinking","Yes","0","0","0","0","0","0.00"
"2025-10-28T08:11:22.308Z","Included","claude-4.5-sonnet-thinking","Yes","4187","7","136163","866","141223","0.08"
"2025-10-28T08:11:13.084Z","Included","claude-4.5-sonnet-thinking","Yes","0","0","0","0","0","0.00"
"2025-10-28T08:11:11.447Z","Included","claude-4.5-sonnet-thinking","Yes","0","0","0","0","0","0.00"
"2025-10-28T08:11:07.477Z","Included","claude-4.5-sonnet-thinking","Yes","125316","981","12060","1838","140195","0.60"
"2025-10-28T08:08:31.373Z","Errored, Not Charged","claude-4.5-sonnet-thinking","Yes","0","0","0","0","0","0.00"
"2025-10-28T08:08:27.652Z","Included","claude-4.5-sonnet-thinking","Yes","1111","7","133141","426","134685","0.06"
"2025-10-28T08:08:22.707Z","Included","claude-4.5-sonnet-thinking","Yes","0","0","0","0","0","0.00"
"2025-10-28T08:08:22.253Z","Included","claude-4.5-sonnet-thinking","Yes","0","0","0","0","0","0.00"
"2025-10-28T08:08:13.800Z","Included","claude-4.5-sonnet-thinking","Yes","1432","6","131709","335","133482","0.06"
"2025-10-28T08:08:02.368Z","Errored, Not Charged","claude-4.5-sonnet-thinking","Yes","1671","8","130038","639","132356","0.07"
"2025-10-28T08:08:02.064Z","Included","claude-4.5-sonnet-thinking","Yes","0","0","0","0","0","0.00"
"2025-10-28T08:07:58.743Z","Included","claude-4.5-sonnet-thinking","Yes","539","7","129499","956","131001","0.07"
"2025-10-28T08:07:49.152Z","Errored, Not Charged","claude-4.5-sonnet-thinking","Yes","2751","8","126748","114","129621","0.06"
"2025-10-28T08:07:44.749Z","Included","claude-4.5-sonnet-thinking","Yes","0","0","0","0","0","0.00"
"2025-10-28T08:07:41.763Z","Included","claude-4.5-sonnet-thinking","Yes","0","0","0","0","0","0.00"
"2025-10-28T08:07:27.853Z","Included","claude-4.5-sonnet-thinking","Yes","3401","8","123347","1700","128456","0.09"
"2025-10-28T08:07:26.797Z","Included","claude-4.5-sonnet-thinking","Yes","0","0","0","0","0","0.00"
"2025-10-28T08:07:21.147Z","Included","claude-4.5-sonnet-thinking","Yes","4158","8","119189","994","124349","0.08"
"2025-10-28T08:07:20.769Z","Included","claude-4.5-sonnet-thinking","Yes","0","0","0","0","0","0.00"
"2025-10-28T08:07:14.608Z","Included","claude-4.5-sonnet-thinking","No","108342","929","12048","287","121606","0.50"
"2025-10-28T08:03:56.312Z","Included","claude-4.5-sonnet-thinking","No","717","2281","114707","4521","122226","0.13"
"2025-10-28T08:03:55.615Z","Included","claude-4.5-sonnet-thinking","Yes","0","0","0","0","0","0.00"
"2025-10-28T08:03:28.208Z","Included","claude-4.5-sonnet-thinking","Yes","2745","4","111088","214","114051","0.06"
"2025-10-28T08:03:16.388Z","Included","claude-4.5-sonnet-thinking","Yes","2106","6","108982","1526","112620","0.08"
"2025-10-28T08:03:02.722Z","Included","claude-4.5-sonnet-thinking","Yes","0","0","0","0","0","0.00"
"2025-10-28T08:02:59.882Z","Included","claude-4.5-sonnet-thinking","Yes","1151","6","107831","949","109937","0.06"
"2025-10-28T08:02:55.229Z","Included","claude-4.5-sonnet-thinking","Yes","0","0","0","0","0","0.00"
"2025-10-28T08:02:45.173Z","Included","claude-4.5-sonnet-thinking","Yes","913","5","106918","297","108133","0.05"
"2025-10-28T08:02:38.891Z","Included","claude-4.5-sonnet-thinking","Yes","3849","7","103069","496","107421","0.06"
"2025-10-28T08:02:37.307Z","Included","claude-4.5-sonnet-thinking","Yes","0","0","0","0","0","0.00"
"2025-10-28T08:02:32.469Z","Included","claude-4.5-sonnet-thinking","Yes","3127","7","99942","267","103343","0.05"
"2025-10-28T08:02:30.838Z","Included","claude-4.5-sonnet-thinking","Yes","0","0","0","0","0","0.00"
"2025-10-28T08:02:11.193Z","Included","claude-4.5-sonnet-thinking","Yes","1000","7","98942","273","100222","0.05"
"2025-10-28T08:02:10.158Z","Included","claude-4.5-sonnet-thinking","Yes","0","0","0","0","0","0.00"
"2025-10-28T08:02:03.902Z","Included","claude-4.5-sonnet-thinking","Yes","6081","7","92861","383","99332","0.07"
"2025-10-28T08:02:02.722Z","Included","claude-4.5-sonnet-thinking","Yes","0","0","0","0","0","0.00"
"2025-10-28T08:01:58.917Z","Included","claude-4.5-sonnet-thinking","Yes","3017","7","89844","270","93138","0.05"
"2025-10-28T08:01:56.787Z","Included","claude-4.5-sonnet-thinking","Yes","0","0","0","0","0","0.00"
"2025-10-28T08:00:52.056Z","Included","claude-4.5-sonnet-thinking","Yes","0","0","0","0","0","0.00"
"2025-10-28T08:00:46.975Z","Included","claude-4.5-sonnet-thinking","Yes","78997","4790","12369","409","96565","0.37"
"2025-10-28T07:54:38.651Z","Included","gpt-5-pro","No","0","83023","851","5125","88999","2.20"
"2025-10-28T07:51:20.173Z","Included","gpt-5-pro","Yes","0","80450","0","707","81157","1.55"
"2025-10-28T07:47:50.759Z","Included","gpt-5-pro","Yes","0","82203","1522","5230","88955","2.18"
"2025-10-28T06:56:29.111Z","Included","claude-4.5-sonnet-thinking","No","238626","8146","889918","16585","1153275","1.42"
"2025-10-27T23:53:25.391Z","Included","claude-4.5-sonnet-thinking","No","483","826","154040","175","155524","0.05"
"2025-10-27T23:49:49.510Z","Included","claude-4.5-sonnet-thinking","No","142001","2231","440304","10521","595057","0.82"
"2025-10-27T23:42:00.176Z","Included","claude-4.5-sonnet-thinking","No","53319","1065","708238","7646","770268","0.53"
"2025-10-27T23:35:54.365Z","Included","claude-4.5-sonnet-thinking","No","50678","6926","734985","6557","799146","0.52"
"2025-10-27T23:34:58.930Z","Included","claude-4.5-sonnet-thinking","No","53398","5372","71672","707","131149","0.24"
"2025-10-27T22:25:18.115Z","Included","claude-4.5-sonnet-thinking","No","48080","1180","124994","2339","176593","0.25"
"2025-10-27T22:19:50.419Z","Included","claude-4.5-sonnet-thinking","No","44174","842","12051","177","57244","0.17"
"2025-10-27T22:07:31.771Z","Included","claude-4.5-sonnet-thinking","No","207488","2206","1520045","11030","1740769","1.40"
"2025-10-27T21:57:26.346Z","Included","claude-4.5-sonnet-thinking","No","136928","5909","414317","18232","575386","0.91"
"2025-10-27T17:42:47.202Z","Included","claude-4.5-sonnet-thinking","No","113804","3288","727067","4448","848607","0.72"
"2025-10-27T17:33:13.569Z","Included","claude-4.5-sonnet-thinking","No","98926","3298","308302","6005","416531","0.55"
"2025-10-27T06:13:56.492Z","Included","claude-4.5-sonnet-thinking","No","3251","1234","166606","3156","174247","0.11"
"2025-10-27T06:12:21.161Z","Included","claude-4.5-sonnet-thinking","No","71321","1019","12673","451","85464","0.28"
"2025-10-27T06:07:01.624Z","Included","claude-4.5-sonnet-thinking","No","71051","854","12055","262","84222","0.27"
"2025-10-27T05:26:24.245Z","Included","claude-4.5-sonnet-thinking","No","46756","854","2061691","12656","2121957","0.98"
"2025-10-27T05:22:19.026Z","Included","claude-4.5-sonnet-thinking","No","33046","2071","181332","4222","220671","0.24"
"2025-10-27T05:20:30.642Z","Included","claude-4.5-sonnet-thinking","No","27760","1926","101402","1844","132932","0.16"
"2025-10-27T00:08:17.304Z","Included","claude-4.5-sonnet-thinking","No","53896","7904","68772","5931","136503","0.32"
"2025-10-26T23:52:11.886Z","Included","claude-4.5-sonnet-thinking","No","44248","1956","51171","553","97928","0.19"
"2025-10-26T23:46:49.893Z","Included","claude-4.5-sonnet-thinking","No","6211","1589","72780","156","80736","0.05"
"2025-10-26T23:45:24.481Z","Included","claude-4.5-sonnet-thinking","No","27254","1321","82867","1181","112623","0.14"
"2025-10-26T23:39:32.958Z","Included","claude-4.5-sonnet-thinking","No","159447","2219","837035","5320","1004021","0.93"
"2025-10-26T23:32:36.578Z","Included","claude-4.5-sonnet-thinking","No","2016","1600","160444","595","164655","0.07"
"2025-10-26T23:29:49.464Z","Included","claude-4.5-sonnet-thinking","No","11658","2140","908211","5941","927950","0.41"
"2025-10-26T23:25:51.663Z","Included","claude-4.5-sonnet-thinking","No","9467","2073","852728","5927","870195","0.38"
"2025-10-26T23:16:54.612Z","Included","claude-4.5-sonnet-thinking","No","126573","4190","924999","6163","1061925","0.85"
"2025-10-26T22:43:39.494Z","Included","claude-4.5-sonnet-thinking","No","110450","1389","131499","1703","245041","0.48"
"2025-10-26T22:30:57.668Z","Included","claude-4.5-sonnet-thinking","No","105927","1868","343580","10210","461585","0.65"
"2025-10-26T17:20:13.433Z","Included","claude-4.5-sonnet-thinking","No","92202","7188","13213","741","113344","0.37"
"2025-10-26T16:53:10.276Z","Included","claude-4.5-sonnet-thinking","No","20375","2184","897768","13335","933662","0.55"
"2025-10-26T16:50:37.659Z","Included","claude-4.5-sonnet-thinking","No","69272","6849","13206","744","90071","0.28"
"2025-10-26T14:33:28.032Z","Included","claude-4.5-sonnet-thinking","No","83291","6404","267145","9628","366468","0.54"
"2025-10-26T14:26:34.561Z","Included","claude-4.5-sonnet-thinking","No","42832","115534","524018","21311","703695","0.50"
"2025-10-26T14:25:02.266Z","Included","claude-4.5-sonnet-thinking","No","1774","1503","336527","617","340421","0.12"
"2025-10-26T14:23:20.634Z","Included","claude-4.5-sonnet-thinking","No","5654","1593","489960","3199","500406","0.22"
"2025-10-26T14:18:43.477Z","Included","claude-4.5-sonnet-thinking","No","1339","1184","322360","612","325495","0.11"
"2025-10-26T14:17:49.747Z","Included","claude-4.5-sonnet-thinking","No","872","1179","320589","369","323009","0.11"
"2025-10-26T14:16:46.611Z","Included","claude-4.5-sonnet-thinking","No","894","1145","318818","346","321203","0.10"
"2025-10-26T14:16:06.048Z","Included","claude-4.5-sonnet-thinking","No","958","1183","316898","380","319419","0.10"
"2025-10-26T14:15:13.507Z","Included","claude-4.5-sonnet-thinking","No","882","1136","315110","368","317496","0.10"
"2025-10-26T14:14:07.877Z","Included","claude-4.5-sonnet-thinking","No","908","1130","313314","366","315718","0.10"
"2025-10-26T14:12:07.366Z","Included","claude-4.5-sonnet-thinking","No","1183","1192","311219","399","313993","0.10"
"2025-10-26T14:06:53.159Z","Included","claude-4.5-sonnet-thinking","No","8999","2187","594154","4925","610265","0.29"
"2025-10-26T14:05:34.186Z","Included","claude-4.5-sonnet-thinking","No","1393","732","289534","582","292241","0.10"
"2025-10-26T14:04:48.866Z","Included","claude-4.5-sonnet-thinking","No","1163","1285","287935","455","290838","0.10"
"2025-10-26T14:02:11.685Z","Included","claude-4.5-sonnet-thinking","No","1263","1307","285438","488","288496","0.10"
"2025-10-26T13:59:34.132Z","Included","claude-4.5-sonnet-thinking","No","5482","1521","689930","2585","699518","0.27"
"2025-10-26T13:54:28.125Z","Included","claude-4.5-sonnet-thinking","No","5603","2978","532419","2006","543006","0.22"
"2025-10-26T13:50:50.832Z","Included","claude-4.5-sonnet-thinking","No","5202","1315","764770","1817","773104","0.28"
"2025-10-26T13:49:57.749Z","Included","claude-4.5-sonnet-thinking","No","1724","1172","374235","748","377879","0.13"
"2025-10-26T13:47:57.093Z","Included","claude-4.5-sonnet-thinking","No","1744","1263","246268","621","249896","0.09"
"2025-10-26T13:46:45.308Z","Included","claude-4.5-sonnet-thinking","No","2533","1517","483386","547","487983","0.16"
"2025-10-26T13:45:31.577Z","Included","claude-4.5-sonnet-thinking","No","2454","1254","353860","1070","358638","0.13"
"2025-10-26T13:43:46.917Z","Included","claude-4.5-sonnet-thinking","No","0","769","1190","19","1978","0.000"
"2025-10-26T13:41:01.981Z","Included","claude-4.5-sonnet-thinking","No","3621","1470","917924","1221","924236","0.31"
"2025-10-26T13:34:13.957Z","Included","claude-4.5-sonnet-thinking","No","3241","1669","781907","1228","788045","0.27"
"2025-10-26T13:32:48.609Z","Included","claude-4.5-sonnet-thinking","No","24580","1080","258412","505","284577","0.18"
"2025-10-26T13:29:52.035Z","Included","claude-4.5-sonnet-thinking","No","2930","1103","334711","1440","340184","0.13"
"2025-10-26T13:24:22.688Z","Included","claude-4.5-sonnet-thinking","No","5778","1270","473082","1697","481827","0.19"
"2025-10-26T13:23:08.211Z","Included","claude-4.5-sonnet-thinking","No","1618","984","151756","915","155273","0.07"
"2025-10-26T13:21:34.600Z","Included","claude-4.5-sonnet-thinking","No","961","999","149837","398","152195","0.05"
"2025-10-26T13:20:44.922Z","Included","claude-4.5-sonnet-thinking","No","957","974","148001","529","150461","0.06"
"2025-10-26T13:19:06.432Z","Included","claude-4.5-sonnet-thinking","No","4790","1076","208153","2941","216960","0.12"
"2025-10-26T13:17:35.183Z","Included","claude-4.5-sonnet-thinking","No","1042","964","136251","539","138796","0.05"
"2025-10-26T13:16:28.422Z","Included","claude-4.5-sonnet-thinking","No","1139","993","134210","380","136722","0.05"
"2025-10-26T13:12:07.062Z","Included","claude-4.5-sonnet-thinking","No","55224","1865","70117","5131","132337","0.31"
"2025-10-26T13:01:53.727Z","Included","claude-4.5-sonnet-thinking","No","1199","1212","114078","419","116908","0.05"
"2025-10-26T12:59:32.114Z","Included","claude-4.5-sonnet-thinking","No","45210","1856","216526","3270","266862","0.29"
"2025-10-26T12:57:47.413Z","Included","claude-4.5-sonnet-thinking","No","4061","1283","171295","1968","178607","0.10"
"2025-10-26T12:55:49.688Z","Included","claude-4.5-sonnet-thinking","No","4209","1578","155122","995","161904","0.08"
"2025-10-26T12:51:27.625Z","Included","claude-4.5-sonnet-thinking","No","1598","1217","72792","865","76472","0.04"
"2025-10-26T12:50:18.865Z","Included","claude-4.5-sonnet-thinking","No","2701","2771","67370","637","73479","0.04"
"2025-10-26T12:48:48.653Z","Included","claude-4.5-sonnet-thinking","No","1531","1163","64207","797","67698","0.04"
"2025-10-26T12:47:09.650Z","Included","claude-4.5-sonnet-thinking","No","1332","1211","92353","663","95559","0.04"
"2025-10-26T12:45:38.208Z","Included","claude-4.5-sonnet-thinking","No","1850","1280","87289","993","91412","0.05"
"2025-10-26T12:43:31.378Z","Included","claude-4.5-sonnet-thinking","No","17128","1294","266450","1992","286864","0.17"
"2025-10-26T12:41:35.475Z","Included","claude-4.5-sonnet-thinking","No","29040","2065","602779","3747","637631","0.35"
"2025-10-26T12:38:10.308Z","Included","claude-4.5-sonnet-thinking","No","4037","2038","560237","3346","569658","0.23"
"2025-10-26T12:36:03.184Z","Included","claude-4.5-sonnet-thinking","No","4016","1979","680072","2592","688659","0.26"
"2025-10-26T12:33:47.994Z","Included","claude-4.5-sonnet-thinking","No","122917","2060","933120","3061","1061158","0.79"
"2025-10-26T12:26:13.492Z","Included","claude-4.5-sonnet-thinking","No","116438","7297","744414","8983","877132","0.80"
"2025-10-26T12:09:07.997Z","Included","claude-4.5-sonnet-thinking","No","83408","124165","1135764","28183","1371520","0.90"
"2025-10-26T12:01:59.987Z","Included","claude-4.5-sonnet-thinking","No","152940","5853","1434794","8157","1601744","1.13"
"2025-10-26T11:55:09.291Z","Included","claude-4.5-sonnet-thinking","No","29618","1872","897901","4313","933704","0.45"
"2025-10-26T11:53:19.781Z","Included","claude-4.5-sonnet-thinking","No","110452","6786","677978","1853","797069","0.65"
"2025-10-26T10:39:30.094Z","Included","claude-4.5-sonnet-thinking","No","160234","11690","2612325","8709","2792958","1.54"
"2025-10-26T09:16:42.437Z","Included","claude-4.5-sonnet-thinking","No","200753","112545","3043377","21664","3378339","1.90"
"2025-10-26T09:08:20.865Z","Included","claude-4.5-sonnet-thinking","No","142470","4366","13136","1176","161148","0.56"
"2025-10-26T08:43:19.276Z","Included","claude-4.5-sonnet-thinking","No","139135","878","310475","2368","452856","0.65"
"2025-10-26T08:09:32.852Z","Included","claude-4.5-sonnet-thinking","No","64813","3253","5991548","21557","6081171","2.36"
"2025-10-26T08:06:14.197Z","Included","claude-4.5-sonnet-thinking","No","71771","5871","13139","779","91560","0.29"
"2025-10-25T06:53:53.342Z","User API Key","gpt-4.1","No","0","0","0","0","0","0.00"
"2025-10-25T06:51:46.171Z","User API Key","claude-4.5-sonnet-thinking","No","0","0","0","0","0","0.00"
"2025-10-25T06:48:23.693Z","User API Key","claude-4.5-sonnet-thinking","No","0","0","0","0","0","0.00"
"2025-10-24T22:42:58.538Z","Included","claude-4.5-sonnet-thinking","No","70465","2533","627455","3587","704040","0.51"
"2025-10-24T22:29:56.853Z","Included","claude-4.5-sonnet-thinking","No","60544","3526","711952","4122","780144","0.50"
"2025-10-24T22:04:33.491Z","Included","claude-4.5-sonnet-thinking","No","54423","2511","3192238","5517","3254689","1.25"
"2025-10-24T22:03:02.491Z","Included","claude-4.5-sonnet-thinking","No","859","2161","166797","466","170283","0.06"
"2025-10-24T22:00:16.561Z","Included","claude-4.5-sonnet-thinking","No","471","1539","166387","565","168962","0.06"
"2025-10-24T21:57:05.955Z","Included","claude-4.5-sonnet-thinking","No","153633","1384","1127712","1612","1284341","0.94"
"2025-10-24T21:48:12.882Z","Included","claude-4.5-sonnet-thinking","No","1513","947","472994","759","476213","0.16"
"2025-10-24T21:47:20.982Z","Included","claude-4.5-sonnet-thinking","No","1881","1031","624234","908","628054","0.21"
"2025-10-24T21:41:03.136Z","Included","claude-4.5-sonnet-thinking","No","13252","1658","2533263","4043","2552216","0.87"
"2025-10-24T21:38:46.089Z","Included","claude-4.5-sonnet-thinking","No","3573","930","139726","224","144453","0.06"
"2025-10-24T21:37:41.290Z","Included","claude-4.5-sonnet-thinking","No","127080","6393","13156","1373","148002","0.51"
"2025-10-24T21:14:19.624Z","Included","claude-4.5-sonnet-thinking","No","11540","3257","393825","5414","414036","0.25"
"2025-10-24T21:13:15.051Z","Included","claude-4.5-sonnet-thinking","No","2173","1347","252653","797","256970","0.10"
"2025-10-24T21:12:23.708Z","Included","claude-4.5-sonnet-thinking","No","451","2207","125770","918","129346","0.05"
"2025-10-24T21:08:30.867Z","Included","claude-4.5-sonnet-thinking","No","17565","9122","1420944","2771","1450402","0.54"
"2025-10-24T21:06:54.648Z","Included","claude-4.5-sonnet-thinking","No","98099","1306","334292","1086","434783","0.48"
"2025-10-24T21:05:52.763Z","Included","claude-4.5-sonnet-thinking","No","896","1086","213842","486","216310","0.07"
"2025-10-24T21:00:27.104Z","Included","claude-4.5-sonnet-thinking","No","94984","1217","222567","582","319350","0.43"
"2025-10-24T20:56:23.543Z","Included","claude-4.5-sonnet-thinking","No","92825","1626","521392","955","616798","0.52"
"2025-10-24T20:51:54.081Z","Included","claude-4.5-sonnet-thinking","No","2135","2602","98614","656","104007","0.05"
"2025-10-24T20:50:51.534Z","Included","claude-4.5-sonnet-thinking","No","85881","2761","12719","473","101834","0.34"
"2025-10-24T20:37:27.200Z","Included","claude-4.5-sonnet-thinking","No","85359","3815","3631604","11693","3732471","1.59"
"2025-10-24T20:28:52.222Z","Included","claude-4.5-sonnet-thinking","No","208","2533","67053","437","70231","0.03"
"2025-10-24T20:27:33.252Z","Included","claude-4.5-sonnet-thinking","No","54351","903","12644","205","68103","0.21"
"2025-10-24T20:22:01.964Z","Included","claude-4.5-sonnet-thinking","No","359","940","65637","143","67079","0.02"
"2025-10-24T20:21:20.923Z","Included","claude-4.5-sonnet-thinking","No","523","1177","65764","305","67769","0.03"
"2025-10-24T20:20:35.800Z","Included","claude-4.5-sonnet-thinking","No","317","1386","65499","447","67649","0.03"
"2025-10-24T20:19:52.018Z","Included","claude-4.5-sonnet-thinking","No","468","966","64936","314","66684","0.03"
"2025-10-24T20:16:03.176Z","Included","claude-4.5-sonnet-thinking","No","52264","796","12039","176","65275","0.20"
"2025-10-24T20:05:48.768Z","Included","claude-4.5-sonnet-thinking","No","5038","1541","486177","1565","494321","0.19"
"2025-10-24T20:04:15.599Z","Included","claude-4.5-sonnet-thinking","No","154","1375","59688","807","62024","0.03"
"2025-10-24T20:03:35.208Z","Included","claude-4.5-sonnet-thinking","No","2870","2384","111839","678","117771","0.06"
"2025-10-24T20:02:37.499Z","Included","claude-4.5-sonnet-thinking","No","718","1411","55979","237","58345","0.02"
"2025-10-24T20:01:37.315Z","Included","claude-4.5-sonnet-thinking","No","612","1428","55352","186","57578","0.02"
"2025-10-24T20:00:41.809Z","Included","claude-4.5-sonnet-thinking","No","42711","1284","12668","292","56955","0.17"
"2025-10-24T19:55:45.457Z","Errored, Not Charged","claude-4.5-sonnet-thinking","No","42151","1539","11994","239","55923","0.17"
"2025-10-24T19:43:08.019Z","Included","claude-4.5-sonnet-thinking","No","6789","2125","1013908","2189","1025011","0.36"
"2025-10-24T19:41:54.648Z","Included","claude-4.5-sonnet-thinking","No","2243","1081","87247","622","91193","0.04"
"2025-10-24T19:40:57.089Z","Included","claude-4.5-sonnet-thinking","No","354","9565","88247","291","98457","0.04"
"2025-10-24T19:39:40.432Z","Included","claude-4.5-sonnet-thinking","No","179","1089","87260","109","88637","0.03"
"2025-10-24T19:38:36.959Z","Included","claude-4.5-sonnet-thinking","No","207","946","87050","85","88288","0.03"
"2025-10-24T19:38:14.781Z","Included","claude-4.5-sonnet-thinking","No","255","952","86803","112","88122","0.03"
"2025-10-24T19:37:41.196Z","Included","claude-4.5-sonnet-thinking","No","556","682","86266","151","87655","0.03"
"2025-10-24T19:37:01.305Z","Included","claude-4.5-sonnet-thinking","No","208","1264","86055","172","87699","0.03"
"2025-10-24T19:35:01.099Z","Included","claude-4.5-sonnet-thinking","No","280","966","85760","103","87109","0.03"
"2025-10-24T19:34:26.075Z","Included","claude-4.5-sonnet-thinking","No","227","1004","85561","183","86975","0.03"
"2025-10-24T19:33:41.304Z","Included","claude-4.5-sonnet-thinking","No","183","964","85357","131","86635","0.03"
"2025-10-24T19:33:14.611Z","Included","claude-4.5-sonnet-thinking","No","537","944","84804","86","86371","0.03"
"2025-10-24T19:32:34.201Z","Included","claude-4.5-sonnet-thinking","No","1558","873","82573","73","85077","0.03"
"2025-10-24T19:31:23.292Z","Included","claude-4.5-sonnet-thinking","No","199","2273","83064","149","85685","0.03"
"2025-10-24T19:30:36.963Z","Included","claude-4.5-sonnet-thinking","No","697","942","82356","104","84099","0.03"
"2025-10-24T19:29:44.959Z","Included","claude-4.5-sonnet-thinking","No","2901","2846","79786","151","85684","0.04"
"2025-10-24T19:28:32.134Z","Included","claude-4.5-sonnet-thinking","No","1554","6772","78472","205","87003","0.04"
"2025-10-24T19:27:27.080Z","Included","claude-4.5-sonnet-thinking","No","1179","2249","76757","217","80402","0.03"
"2025-10-24T19:25:58.286Z","Included","claude-4.5-sonnet-thinking","No","269","1908","76455","122","78754","0.03"
"2025-10-24T19:25:07.640Z","Included","claude-4.5-sonnet-thinking","No","227","674","76245","171","77317","0.03"
"2025-10-24T19:24:34.804Z","Included","claude-4.5-sonnet-thinking","No","589","952","75645","132","77318","0.03"
"2025-10-24T19:23:56.861Z","Included","claude-4.5-sonnet-thinking","No","242","1309","75398","132","77081","0.03"
"2025-10-24T19:22:56.838Z","Included","claude-4.5-sonnet-thinking","No","314","973","75093","140","76520","0.03"
"2025-10-24T19:21:55.079Z","Included","claude-4.5-sonnet-thinking","No","1748","1030","73368","209","76355","0.03"
"2025-10-24T19:20:19.759Z","Included","claude-4.5-sonnet-thinking","No","1069","1773","72469","1644","76955","0.05"
"2025-10-24T19:19:29.293Z","Included","claude-4.5-sonnet-thinking","No","59651","1963","12850","823","75287","0.24"
"2025-10-24T19:02:58.462Z","Included","claude-4.5-sonnet-thinking","No","2117","4241","135300","1526","143184","0.08"
"2025-10-24T18:59:01.835Z","Included","claude-4.5-sonnet-thinking","No","55804","14939","1283295","3597","1357635","0.69"
"2025-10-24T18:45:07.321Z","Included","claude-4.5-sonnet-thinking","No","90641","146175","1403759","31174","1671749","0.97"
"2025-10-24T18:41:48.486Z","Included","claude-4.5-sonnet-thinking","No","154120","2013","12691","405","169229","0.59"
"2025-10-24T18:30:33.215Z","Included","claude-4.5-sonnet-thinking","No","1955","2771","985759","1003","991488","0.32"
"2025-10-24T18:28:41.482Z","Included","claude-4.5-sonnet-thinking","No","838","1448","164109","820","167215","0.06"
"2025-10-24T18:27:56.703Z","Included","claude-4.5-sonnet-thinking","No","1776","1458","162270","463","165967","0.06"
"2025-10-24T18:19:07.700Z","Included","claude-4.5-sonnet-thinking","No","18222","21114","2265940","8400","2313676","0.93"
"2025-10-24T18:18:13.429Z","Included","claude-4.5-sonnet-thinking","No","2417","2807","283599","1340","290163","0.12"
"2025-10-24T18:16:11.495Z","Included","claude-4.5-sonnet-thinking","No","3706","2935","277505","594","284740","0.11"
"2025-10-24T18:14:16.982Z","Included","claude-4.5-sonnet-thinking","No","125206","4615","148635","1994","280450","0.55"
"2025-10-24T17:56:45.178Z","Included","claude-4.5-sonnet-thinking","No","27817","29908","1096412","2092","1156229","0.55"
"2025-10-24T17:55:21.652Z","Included","claude-4.5-sonnet-thinking","No","94876","2803","12772","784","111235","0.38"
"2025-10-24T17:46:36.590Z","Included","claude-4.5-sonnet-thinking","No","7775","8459","602226","910","619370","0.25"
"2025-10-24T17:45:39.483Z","Included","claude-4.5-sonnet-thinking","No","2314","7410","95035","1502","106261","0.07"
"2025-10-24T17:39:15.685Z","Included","claude-4.5-sonnet-thinking","No","12607","14994","1033758","5720","1067079","0.48"
"2025-10-24T17:38:13.248Z","Included","claude-4.5-sonnet-thinking","No","3304","4702","394368","1286","403660","0.16"
"2025-10-24T17:33:55.707Z","Included","claude-4.5-sonnet-thinking","No","65917","18010","211193","8692","303812","0.49"
"2025-10-24T17:12:24.022Z","Errored, Not Charged","claude-4.5-sonnet-thinking","No","73798","20735","217740","6071","318344","0.48"
"2025-10-24T17:11:42.427Z","Included","claude-4.5-sonnet-thinking","No","159811","3342","12888","468","176509","0.61"
"2025-10-24T16:57:43.875Z","Included","claude-4.5-sonnet-thinking","No","2903","3677","505033","578","512191","0.18"
"2025-10-24T16:55:10.344Z","Included","claude-4.5-sonnet-thinking","No","155723","2900","178114","1104","337841","0.66"
"2025-10-24T16:49:22.740Z","Included","claude-4.5-sonnet-thinking","No","3137","2674","162250","622","168683","0.07"
"2025-10-24T16:44:46.755Z","Included","claude-4.5-sonnet-thinking","No","10593","12481","1726852","3643","1753569","0.65"
"2025-10-24T16:43:47.083Z","Included","claude-4.5-sonnet-thinking","No","1841","3765","151875","598","158079","0.07"
"2025-10-24T16:40:08.603Z","Included","claude-4.5-sonnet-thinking","No","138905","10067","1046677","2404","1198053","0.89"
"2025-10-24T16:27:14.568Z","Included","claude-4.5-sonnet-thinking","No","4299","4965","852146","1795","863205","0.31"
"2025-10-24T16:20:56.941Z","Included","claude-4.5-sonnet-thinking","No","7102","8373","1367089","1875","1384439","0.48"
"2025-10-24T16:18:04.650Z","Included","claude-4.5-sonnet-thinking","No","7230","8521","1558225","2419","1576395","0.55"
"2025-10-24T16:13:38.169Z","Included","claude-4.5-sonnet-thinking","No","8857","10446","966903","4589","990795","0.42"
"2025-10-24T16:10:31.887Z","Included","claude-4.5-sonnet-thinking","No","7687","12071","670298","3583","693639","0.31"
"2025-10-24T16:07:24.637Z","Included","claude-4.5-sonnet-thinking","No","15421","23874","990902","4571","1034768","0.49"
"2025-10-24T15:59:46.534Z","Included","claude-4.5-sonnet-thinking","No","82427","23715","832400","8140","946682","0.74"
"2025-10-24T15:49:27.153Z","Errored, Not Charged","claude-4.5-sonnet-thinking","No","60445","51762","1660395","10740","1783342","1.02"
"2025-10-24T15:47:54.225Z","Included","claude-4.5-sonnet-thinking","No","160298","5585","12383","867","179133","0.62"
"2025-10-24T15:36:50.263Z","Included","claude-4.5-sonnet-thinking","No","158968","23791","1819643","7529","2009931","1.31"
"2025-10-24T15:29:05.497Z","Included","claude-4.5-sonnet-thinking","No","7654","10615","1230463","2935","1251667","0.47"
"2025-10-24T15:26:04.711Z","Included","claude-4.5-sonnet-thinking","No","1360","2840","299695","537","304432","0.11"
"2025-10-24T15:23:27.738Z","Included","claude-4.5-sonnet-thinking","No","3945","4359","731433","1178","740915","0.26"
"2025-10-24T15:20:29.075Z","Included","claude-4.5-sonnet-thinking","No","3406","4522","1000411","1190","1009529","0.34"
"2025-10-24T15:15:55.139Z","Included","claude-4.5-sonnet-thinking","No","129961","7090","1122206","1941","1261198","0.87"
"2025-10-24T15:05:25.614Z","Included","claude-4.5-sonnet-thinking","No","128782","7129","1078529","2388","1216828","0.86"
"2025-10-24T15:04:20.774Z","Included","claude-4.5-sonnet-thinking","No","1885","1194","131662","323","135064","0.05"
"2025-10-24T14:59:07.268Z","Included","claude-4.5-sonnet-thinking","No","5888","9622","1148387","2275","1166172","0.42"
"2025-10-24T14:56:42.059Z","Included","claude-4.5-sonnet-thinking","No","9744","11531","947647","1778","970700","0.38"
"2025-10-24T14:53:28.090Z","Included","claude-4.5-sonnet-thinking","No","6957","9129","1328489","3174","1347749","0.49"
"2025-10-24T14:50:22.413Z","Included","claude-4.5-sonnet-thinking","No","8034","14272","1033270","4915","1060491","0.45"
"2025-10-24T14:47:56.232Z","Included","claude-4.5-sonnet-thinking","No","7963","7580","573714","2291","591548","0.25"
"2025-10-24T14:44:08.248Z","Included","claude-4.5-sonnet-thinking","No","16544","15521","420183","2803","455051","0.27"
"2025-10-24T14:40:03.114Z","Included","claude-4.5-sonnet-thinking","No","9091","12964","686268","3803","712126","0.33"
"2025-10-24T14:36:26.594Z","Included","claude-4.5-sonnet-thinking","No","664","1825","73208","2094","77791","0.06"
"2025-10-24T14:33:38.001Z","Included","claude-4.5-sonnet-thinking","No","5872","6307","273854","1183","287216","0.14"
"2025-10-24T14:30:48.096Z","Included","claude-4.5-sonnet-thinking","No","16490","26330","756576","5985","805381","0.44"
"2025-10-24T14:28:00.351Z","Included","claude-4.5-sonnet-thinking","No","8622","1848","42229","1162","53861","0.06"
"2025-10-24T14:23:56.276Z","Errored, Not Charged","claude-4.5-sonnet-thinking","No","37651","11670","351606","4667","405594","0.35"
"2025-10-24T14:19:38.308Z","Included","claude-4.5-sonnet-thinking","No","5385","5620","833663","1564","846232","0.31"
"2025-10-24T14:17:05.007Z","Included","claude-4.5-sonnet-thinking","No","8533","11305","1124119","2891","1146848","0.44"
"2025-10-24T14:11:15.433Z","Included","claude-4.5-sonnet-thinking","No","26770","28751","1136442","9617","1201580","0.66"
"2025-10-24T14:07:09.879Z","Included","claude-4.5-sonnet-thinking","No","3682","2350","127139","2401","135572","0.09"
"2025-10-24T14:06:26.469Z","Included","claude-4.5-sonnet-thinking","No","114341","3479","12841","1962","132623","0.47"
"2025-10-24T13:59:38.731Z","Included","claude-4.5-sonnet-thinking","No","8383","17079","707012","1518","733992","0.31"
"2025-10-24T13:56:13.813Z","Included","claude-4.5-sonnet-thinking","No","12982","18317","958773","2609","992681","0.43"
"2025-10-24T13:52:59.735Z","Included","claude-4.5-sonnet-thinking","No","6888","7337","580124","2257","596606","0.25"
"2025-10-24T13:48:47.338Z","Included","claude-4.5-sonnet-thinking","No","23654","27487","1091887","5177","1148205","0.57"
"2025-10-24T13:46:20.668Z","Included","claude-4.5-sonnet-thinking","No","3096","8765","208154","1899","221914","0.13"
"2025-10-24T13:43:36.994Z","Included","claude-4.5-sonnet-thinking","No","1641","5346","200443","1221","208651","0.10"
"2025-10-24T13:41:19.484Z","Included","claude-4.5-sonnet-thinking","No","6879","5852","184441","1441","198613","0.12"
"2025-10-24T13:39:21.953Z","Included","claude-4.5-sonnet-thinking","No","1639","7304","174630","1771","185344","0.10"
"2025-10-24T13:36:52.156Z","Included","claude-4.5-sonnet-thinking","No","5049","4425","162035","1653","173162","0.10"
"2025-10-24T13:35:52.690Z","Included","claude-4.5-sonnet-thinking","No","13495","6146","138169","1657","159467","0.13"
"2025-10-24T13:28:38.313Z","Errored, Not Charged","claude-4.5-sonnet-thinking","No","38591","21196","565486","3470","628743","0.43"
"2025-10-24T13:25:49.466Z","Included","claude-4.5-sonnet-thinking","No","2743","5011","680366","1124","689244","0.24"
"2025-10-24T13:24:33.398Z","Included","claude-4.5-sonnet-thinking","No","3790","3730","499919","1209","508648","0.19"
"2025-10-24T13:22:59.620Z","Included","claude-4.5-sonnet-thinking","No","2108","1983","164611","446","169148","0.07"
"2025-10-24T13:21:33.449Z","Included","claude-4.5-sonnet-thinking","No","5230","7519","639436","1630","653815","0.25"
"2025-10-24T13:20:02.572Z","Included","claude-4.5-sonnet-thinking","No","5407","3796","465042","1271","475516","0.19"
"2025-10-24T13:16:15.451Z","Included","claude-4.5-sonnet-thinking","No","19125","13798","1611854","3981","1648758","0.65"
"2025-10-24T13:13:39.239Z","Included","claude-4.5-sonnet-thinking","No","11097","14095","1204580","5344","1235116","0.52"
"2025-10-24T13:12:20.610Z","Included","claude-4.5-sonnet-thinking","No","5971","4189","377558","1595","389313","0.17"
"2025-10-24T13:09:22.335Z","Included","claude-4.5-sonnet-thinking","No","7647","9732","723018","2687","743084","0.31"
"2025-10-24T13:06:56.713Z","Included","claude-4.5-sonnet-thinking","No","3514","6047","340142","535","350238","0.14"
"2025-10-24T13:05:32.105Z","Included","claude-4.5-sonnet-thinking","No","1304","1819","112239","362","115724","0.05"
"2025-10-24T13:04:26.974Z","Included","claude-4.5-sonnet-thinking","No","504","1919","111758","431","114612","0.04"
"2025-10-24T13:03:08.226Z","Included","claude-4.5-sonnet-thinking","No","5201","6568","535483","1247","548499","0.21"
"2025-10-24T12:58:46.487Z","Included","claude-4.5-sonnet-thinking","No","3617","3854","516020","1205","524696","0.19"
"2025-10-24T12:56:47.237Z","Included","claude-4.5-sonnet-thinking","No","2109","1822","100794","245","104970","0.04"
"2025-10-24T12:56:01.259Z","Included","claude-4.5-sonnet-thinking","No","2539","4889","293275","983","301686","0.12"
"2025-10-24T12:53:13.439Z","Included","claude-4.5-sonnet-thinking","No","7285","8352","741125","1989","758751","0.30"
"2025-10-24T12:51:51.029Z","Included","claude-4.5-sonnet-thinking","No","512","2691","89878","220","93301","0.03"
"2025-10-24T12:48:47.573Z","Included","claude-4.5-sonnet-thinking","No","4143","5070","257111","1155","267479","0.12"
"2025-10-24T12:45:54.585Z","Included","claude-4.5-sonnet-thinking","No","7239","6038","405917","1632","420826","0.19"
"2025-10-24T12:43:59.717Z","Included","claude-4.5-sonnet-thinking","No","5324","5887","453210","1528","465949","0.19"
"2025-10-24T12:40:05.839Z","Included","claude-4.5-sonnet-thinking","No","61086","15878","1093999","4311","1175274","0.66"
"2025-10-24T12:32:13.941Z","Errored, Not Charged","claude-4.5-sonnet-thinking","No","56086","52641","1494004","6202","1608933","0.90"
"2025-10-24T12:25:54.668Z","Included","claude-4.5-sonnet-thinking","No","1210","3807","344069","537","349623","0.12"
"2025-10-24T12:24:39.294Z","Included","claude-4.5-sonnet-thinking","No","3285","2158","849145","721","855309","0.28"
"2025-10-24T12:22:44.663Z","Included","claude-4.5-sonnet-thinking","No","1149","2742","335822","290","340003","0.11"
"2025-10-24T12:21:30.626Z","Included","claude-4.5-sonnet-thinking","No","1044","1669","167413","549","170675","0.06"
"2025-10-24T12:17:51.708Z","Included","claude-4.5-sonnet-thinking","No","5005","5550","978481","2492","991528","0.36"
"2025-10-24T12:16:37.723Z","Included","claude-4.5-sonnet-thinking","No","149614","2814","651580","1233","805241","0.78"
"2025-10-24T12:09:46.137Z","Included","claude-4.5-sonnet-thinking","No","4172","6213","622884","1059","634328","0.23"
"2025-10-24T12:08:29.553Z","Included","claude-4.5-sonnet-thinking","No","3910","5471","301311","528","311220","0.13"
"2025-10-24T12:07:00.690Z","Included","claude-4.5-sonnet-thinking","No","6583","8150","575049","4213","593995","0.28"
"2025-10-24T12:04:38.112Z","Included","claude-4.5-sonnet-thinking","No","131441","6959","853669","1333","993402","0.78"
"2025-10-24T11:58:23.612Z","Included","claude-4.5-sonnet-thinking","No","7183","10565","1332741","2197","1352686","0.49"
"2025-10-24T11:55:02.878Z","Included","claude-4.5-sonnet-thinking","No","8792","11370","874777","4757","899696","0.40"
"2025-10-24T11:51:24.587Z","Included","claude-4.5-sonnet-thinking","No","6007","4789","474950","1292","487038","0.19"
"2025-10-24T11:48:23.378Z","Included","claude-4.5-sonnet-thinking","No","11503","10596","1007904","3843","1033846","0.43"
"2025-10-24T11:43:10.213Z","Included","claude-4.5-sonnet-thinking","No","12466","8722","712599","2202","735989","0.31"
"2025-10-24T11:37:14.262Z","Included","claude-4.5-sonnet-thinking","No","10061","11592","1217404","2957","1242014","0.48"
"2025-10-24T11:31:36.028Z","Included","claude-4.5-sonnet-thinking","No","78531","5750","358407","1425","444113","0.44"
"2025-10-24T11:25:21.450Z","Included","claude-4.5-sonnet-thinking","No","1849","1921","253375","685","257830","0.09"
"2025-10-24T11:23:07.800Z","Included","claude-4.5-sonnet-thinking","No","7302","4247","238637","1441","251627","0.13"
"2025-10-24T11:19:57.875Z","Included","claude-4.5-sonnet-thinking","No","1106","6036","151525","2717","161384","0.10"
"2025-10-24T11:15:33.183Z","Included","claude-4.5-sonnet-thinking","No","1776","7314","222584","1017","232691","0.10"
"2025-10-24T11:11:27.429Z","Included","claude-4.5-sonnet-thinking","No","402","2271","146421","1184","150278","0.07"
"2025-10-24T11:10:01.999Z","Included","claude-4.5-sonnet-thinking","No","718","1083","73194","303","75298","0.03"
"2025-10-24T11:09:26.267Z","Included","claude-4.5-sonnet-thinking","No","4835","1386","68426","541","75188","0.05"
"2025-10-24T11:05:19.074Z","Included","claude-4.5-sonnet-thinking","No","6116","6970","399134","1814","414034","0.19"
"2025-10-24T11:04:07.484Z","Included","claude-4.5-sonnet-thinking","No","2953","4934","184263","1036","193186","0.09"
"2025-10-24T11:02:39.000Z","Included","claude-4.5-sonnet-thinking","No","48711","1843","72104","697","123355","0.22"
"2025-10-24T10:47:18.086Z","Included","claude-4.5-sonnet-thinking","No","47726","11547","707733","2384","769390","0.46"
"2025-10-24T10:38:10.935Z","Included","claude-4.5-sonnet-thinking","No","1230","1722","146159","527","149638","0.06"
"2025-10-24T10:37:37.634Z","Included","claude-4.5-sonnet-thinking","No","238","1262","48720","636","50856","0.02"
"2025-10-24T10:36:52.546Z","Included","claude-4.5-sonnet-thinking","No","241","967","48872","143","50223","0.02"
"2025-10-24T10:36:32.172Z","Included","claude-4.5-sonnet-thinking","No","234","964","48638","146","49982","0.02"
"2025-10-24T10:35:59.102Z","Included","claude-4.5-sonnet-thinking","No","237","960","48399","139","49735","0.02"
"2025-10-24T10:35:43.505Z","Included","claude-4.5-sonnet-thinking","No","222","961","48177","142","49502","0.02"
"2025-10-24T10:34:37.967Z","Included","claude-4.5-sonnet-thinking","No","233","957","47941","126","49257","0.02"
"2025-10-24T10:34:25.791Z","Included","claude-4.5-sonnet-thinking","No","230","965","47710","137","49042","0.02"
"2025-10-24T10:33:48.162Z","Included","claude-4.5-sonnet-thinking","No","216","955","47497","134","48802","0.02"
"2025-10-24T10:33:32.732Z","Included","claude-4.5-sonnet-thinking","No","294","954","47200","120","48568","0.02"
"2025-10-24T10:33:02.737Z","Included","claude-4.5-sonnet-thinking","No","732","1026","46476","141","48375","0.02"
"2025-10-24T10:32:21.549Z","Included","claude-4.5-sonnet-thinking","No","33847","1875","57148","331","93201","0.15"
"2025-10-24T10:19:43.260Z","Errored, Not Charged","claude-4.5-sonnet-thinking","No","191238","3633","23623","2965","221459","0.78"
"2025-10-24T10:10:45.193Z","Included","claude-4.5-sonnet-thinking","No","6008","1930","162553","4410","174901","0.14"
"2025-10-24T10:05:48.401Z","Included","claude-4.5-sonnet-thinking","No","7415","11271","1134799","1817","1155302","0.42"
"2025-10-24T10:04:41.051Z","Included","claude-4.5-sonnet-thinking","No","734","2593","158846","730","162903","0.06"
"2025-10-24T10:01:44.997Z","Included","claude-4.5-sonnet-thinking","No","4605","3646","620367","1177","629795","0.23"
"2025-10-24T09:56:55.319Z","Included","claude-4.5-sonnet-thinking","No","5522","7008","747426","4217","764173","0.32"
"2025-10-24T09:55:56.560Z","Included","claude-4.5-sonnet-thinking","No","2830","2347","292177","1551","298905","0.12"
"2025-10-24T09:54:45.859Z","Included","claude-4.5-sonnet-thinking","No","2651","3146","286923","378","293098","0.11"
"2025-10-24T09:54:03.442Z","Included","claude-4.5-sonnet-thinking","No","2412","3304","281869","764","288349","0.11"
"2025-10-24T09:53:08.347Z","Included","claude-4.5-sonnet-thinking","No","1547","2846","139255","614","144262","0.06"
"2025-10-24T09:50:03.873Z","Included","claude-4.5-sonnet-thinking","No","6001","10570","809335","1592","827498","0.31"
"2025-10-24T09:48:21.944Z","Included","claude-4.5-sonnet-thinking","No","6457","10218","1285006","2163","1303844","0.47"
"2025-10-24T09:44:57.028Z","Included","claude-4.5-sonnet-thinking","No","114045","27124","1747618","5415","1894202","1.11"
"2025-10-24T09:33:40.601Z","Errored, Not Charged","claude-4.5-sonnet-thinking","No","87787","142913","2871372","12745","3114817","1.79"
"2025-10-24T09:31:48.737Z","Included","claude-4.5-sonnet-thinking","No","11781","14393","1347957","2737","1376868","0.53"
"2025-10-24T09:28:19.891Z","Included","claude-4.5-sonnet-thinking","No","2363","5893","485929","639","494824","0.18"
"2025-10-24T09:26:39.468Z","Included","claude-4.5-sonnet-thinking","No","3008","6645","796563","1009","807225","0.28"
"2025-10-24T09:24:28.162Z","Included","claude-4.5-sonnet-thinking","No","145927","5910","479881","841","632559","0.72"
"2025-10-24T09:10:43.218Z","Included","claude-4.5-sonnet-thinking","No","4311","2143","456780","750","463984","0.17"
"2025-10-24T09:08:59.868Z","Included","claude-4.5-sonnet-thinking","No","10479","18689","1011232","3025","1043425","0.43"
"2025-10-24T09:04:59.142Z","Included","claude-4.5-sonnet-thinking","No","10277","12306","1062040","2036","1086659","0.42"
"2025-10-24T09:02:48.824Z","Included","claude-4.5-sonnet-thinking","No","2102","3977","384613","622","391314","0.14"
"2025-10-24T08:57:21.971Z","Included","claude-4.5-sonnet-thinking","No","11780","24301","1071890","4710","1112681","0.50"
"2025-10-24T08:54:49.071Z","Included","claude-4.5-sonnet-thinking","No","586","2688","115656","447","119377","0.05"
"2025-10-24T08:53:11.844Z","Included","claude-4.5-sonnet-thinking","No","724","1226","114945","453","117348","0.04"
"2025-10-24T08:47:34.029Z","Included","claude-4.5-sonnet-thinking","No","102235","7931","671001","2234","783401","0.64"
"2025-10-24T08:25:28.169Z","Included","claude-4.5-sonnet-thinking","No","12716","13420","1396959","2648","1425743","0.54"
"2025-10-24T08:24:02.161Z","Included","claude-4.5-sonnet-thinking","No","3064","6299","371530","694","381587","0.15"
"2025-10-24T08:18:57.952Z","Included","claude-4.5-sonnet-thinking","No","1923","3922","180072","823","186740","0.08"
"2025-10-24T08:16:50.316Z","Included","claude-4.5-sonnet-thinking","No","2747","4812","435523","1122","444204","0.17"
"2025-10-24T08:16:16.308Z","Included","claude-4.5-sonnet-thinking","No","74604","1006","12042","129","87781","0.29"
"2025-10-24T07:55:55.652Z","Errored, Not Charged","claude-4.5-sonnet-thinking","No","70591","26304","1852714","6813","1956422","1.00"
"2025-10-24T07:50:07.570Z","Included","claude-4.5-sonnet-thinking","No","19878","21306","2808100","7364","2856648","1.09"
"2025-10-24T07:49:05.932Z","Included","claude-4.5-sonnet-thinking","No","3427","1717","153582","1348","160074","0.08"
"2025-10-24T07:47:33.204Z","Included","claude-4.5-sonnet-thinking","No","2267","2153","151376","3272","159068","0.10"
"2025-10-24T07:45:41.927Z","Included","claude-4.5-sonnet-thinking","No","2663","3094","297840","1241","304838","0.12"
"2025-10-24T07:43:18.580Z","Included","claude-4.5-sonnet-thinking","No","2417","9165","146819","671","159072","0.07"
"2025-10-24T07:40:05.562Z","Included","claude-4.5-sonnet-thinking","No","1210","3426","288755","923","294314","0.11"
"2025-10-24T07:38:25.720Z","Included","claude-4.5-sonnet-thinking","No","6613","12983","843032","1395","864023","0.32"
"2025-10-24T07:32:45.257Z","Included","claude-4.5-sonnet-thinking","No","3235","2997","677657","1131","685020","0.24"
"2025-10-24T07:30:40.795Z","Included","claude-4.5-sonnet-thinking","No","1621","1769","133563","1879","138832","0.07"
"2025-10-24T07:26:05.856Z","Included","claude-4.5-sonnet-thinking","No","120748","14282","919807","1809","1056646","0.78"
"2025-10-24T07:00:29.357Z","Included","claude-4.5-sonnet-thinking","No","887","2716","249598","1876","255077","0.11"
"2025-10-24T06:58:41.185Z","Included","claude-4.5-sonnet-thinking","No","7645","7026","599028","1302","615001","0.24"
"2025-10-24T06:55:59.806Z","Included","claude-4.5-sonnet-thinking","No","842","2753","232553","732","236880","0.09"
"2025-10-24T06:52:51.940Z","Included","claude-4.5-sonnet-thinking","No","104143","11110","1120537","2545","1238335","0.79"
"2025-10-24T06:45:28.299Z","Included","claude-4.5-sonnet-thinking","No","10909","11904","1018742","2271","1043826","0.41"
"2025-10-24T06:43:46.326Z","Included","claude-4.5-sonnet-thinking","No","85044","2867","108453","805","197169","0.37"
"2025-10-24T06:04:11.069Z","On-Demand","claude-4.5-sonnet-thinking","No","10845","14094","1063183","2928","1091050","0.44"
"2025-10-24T06:00:41.313Z","On-Demand","claude-4.5-sonnet-thinking","No","9089","14206","396181","1460","420936","0.20"
"2025-10-24T05:58:06.477Z","On-Demand","claude-4.5-sonnet-thinking","No","63336","4019","86665","1545","155565","0.29"
"2025-10-24T05:46:24.058Z","On-Demand","claude-4.5-sonnet-thinking","No","62191","17061","499955","4300","583507","0.47"
"2025-10-24T05:37:31.527Z","On-Demand","claude-4.5-sonnet-thinking","No","0","4131","66953","447","71531","0.03"
"2025-10-24T05:35:24.048Z","On-Demand","claude-4.5-sonnet-thinking","No","8555","9551","603508","3040","624654","0.28"
"2025-10-24T05:34:12.530Z","On-Demand","claude-4.5-sonnet-thinking","No","5792","5726","266790","2079","280387","0.15"
"2025-10-24T05:30:55.355Z","On-Demand","claude-4.5-sonnet-thinking","No","39530","4879","109768","939","155116","0.21"
"2025-10-24T05:25:53.847Z","Errored, Not Charged","claude-4.5-sonnet-thinking","No","36075","1452","59357","451","97335","0.16"
"2025-10-23T23:10:30.943Z","On-Demand","claude-4.5-sonnet-thinking","No","7960","7893","1542127","1696","1559676","0.54"
"2025-10-23T23:07:35.071Z","On-Demand","claude-4.5-sonnet-thinking","No","8500","12159","2463857","3041","2487557","0.85"
"2025-10-23T23:05:14.523Z","On-Demand","claude-4.5-sonnet-thinking","No","3214","4619","1422679","1661","1432173","0.47"
"2025-10-23T23:02:58.309Z","On-Demand","claude-4.5-sonnet-thinking","No","5862","7361","1380368","2603","1396194","0.49"
"2025-10-23T23:00:58.031Z","On-Demand","claude-4.5-sonnet-thinking","No","3882","4987","890739","1445","901053","0.31"
"2025-10-23T22:59:46.753Z","On-Demand","claude-4.5-sonnet-thinking","No","136733","4178","735141","867","876919","0.76"
"2025-10-23T22:51:35.235Z","On-Demand","claude-4.5-sonnet-thinking","No","11254","18283","2324494","4166","2358197","0.85"
"2025-10-23T22:47:49.260Z","On-Demand","claude-4.5-sonnet-thinking","No","3523","5370","1168322","1601","1178816","0.40"
"2025-10-23T22:47:31.089Z","On-Demand","claude-4.5-sonnet-thinking","No","118190","910","10887","173","130160","0.45"
"2025-10-23T22:38:20.915Z","On-Demand","claude-4.5-sonnet-thinking","No","2501","4657","505110","830","513098","0.18"
"2025-10-23T22:34:23.269Z","On-Demand","claude-4.5-sonnet-thinking","No","2371","6169","618181","911","627632","0.22"
"2025-10-23T22:29:51.236Z","On-Demand","claude-4.5-sonnet-thinking","No","2958","4434","484042","723","492157","0.17"
"2025-10-23T22:28:13.550Z","On-Demand","claude-4.5-sonnet-thinking","No","629","2337","239382","647","242995","0.09"
"2025-10-23T22:27:23.015Z","On-Demand","claude-4.5-sonnet-thinking","No","2407","1029","235478","995","239909","0.10"
"2025-10-23T22:25:32.622Z","On-Demand","claude-4.5-sonnet-thinking","No","1629","2327","232743","1159","237858","0.10"
"2025-10-23T22:24:24.598Z","On-Demand","claude-4.5-sonnet-thinking","No","1984","3300","341569","1071","347924","0.13"
"2025-10-23T22:23:30.477Z","On-Demand","claude-4.5-sonnet-thinking","No","103061","1219","11502","299","116081","0.39"
"2025-10-23T22:03:39.604Z","On-Demand","claude-4.5-sonnet-thinking","No","978","913","112795","147","114833","0.04"
"2025-10-23T22:02:21.609Z","On-Demand","claude-4.5-sonnet-thinking","No","4429","9532","658197","1333","673491","0.25"
"2025-10-23T21:58:45.232Z","On-Demand","claude-4.5-sonnet-thinking","No","3301","5076","738956","1586","748919","0.27"
"2025-10-23T21:54:01.757Z","On-Demand","claude-4.5-sonnet-thinking","No","94177","11123","723569","1558","830427","0.61"
"2025-10-23T21:48:00.617Z","On-Demand","claude-4.5-sonnet-thinking","No","13226","21906","2328346","4528","2368006","0.88"
"2025-10-23T21:41:34.227Z","On-Demand","claude-4.5-sonnet-thinking","No","9742","14936","1626674","3579","1654931","0.62"
"2025-10-23T21:39:35.188Z","On-Demand","claude-4.5-sonnet-thinking","No","5795","6112","812819","2039","826765","0.31"
"2025-10-23T21:36:23.036Z","On-Demand","claude-4.5-sonnet-thinking","No","5974","7806","269771","1724","285275","0.15"
"2025-10-23T21:31:56.190Z","On-Demand","claude-4.5-sonnet-thinking","No","4758","4774","249142","1069","259743","0.12"
"2025-10-23T21:26:52.291Z","On-Demand","claude-4.5-sonnet-thinking","No","533","1176","61118","297","63124","0.02"
"2025-10-23T21:23:13.116Z","On-Demand","claude-4.5-sonnet-thinking","No","49609","4880","300034","1020","355543","0.30"
"2025-10-23T21:16:23.892Z","On-Demand","claude-4.5-sonnet-thinking","No","3258","2907","270020","1144","277329","0.12"
"2025-10-23T21:15:27.843Z","On-Demand","claude-4.5-sonnet-thinking","No","3741","2512","49873","579","56705","0.04"
"2025-10-23T21:13:44.039Z","On-Demand","claude-4.5-sonnet-thinking","No","1056","4272","48842","707","54877","0.04"
"2025-10-23T21:11:25.035Z","On-Demand","claude-4.5-sonnet-thinking","No","37249","875","10918","664","49706","0.15"
"2025-10-23T21:05:55.750Z","On-Demand","claude-4.5-sonnet-thinking","No","2223","9674","43113","716","55726","0.04"
"2025-10-23T21:04:12.954Z","On-Demand","claude-4.5-sonnet-thinking","No","828","2757","41682","590","45857","0.03"
"2025-10-23T20:59:33.511Z","Errored, Not Charged","claude-4.5-sonnet-thinking","No","30115","1342","11616","853","43926","0.13"
"2025-10-23T20:50:41.587Z","On-Demand","claude-4.5-sonnet-thinking","No","498","1295","178153","546","180492","0.06"
"2025-10-23T20:50:21.157Z","On-Demand","claude-4.5-sonnet-thinking","No","1367","1182","176756","371","179676","0.06"
"2025-10-23T20:48:26.695Z","On-Demand","claude-4.5-sonnet-thinking","No","3793","4864","1042813","1326","1052796","0.36"
"2025-10-23T20:43:27.626Z","On-Demand","claude-4.5-sonnet-thinking","No","2596","3203","682494","1107","689400","0.24"
"2025-10-23T20:41:51.560Z","On-Demand","claude-4.5-sonnet-thinking","No","158822","2422","11567","545","173356","0.61"
"2025-10-23T20:34:21.473Z","On-Demand","claude-4.5-sonnet-thinking","No","2833","5224","998996","1229","1008282","0.34"
"2025-10-23T20:32:33.059Z","On-Demand","claude-4.5-sonnet-thinking","No","155435","1213","11564","498","168710","0.59"
"2025-10-23T20:21:22.093Z","On-Demand","claude-4.5-sonnet-thinking","No","151729","4241","11578","640","168188","0.59"
"2025-10-23T20:14:11.500Z","On-Demand","claude-4.5-sonnet-thinking","No","3537","6946","949562","1499","961544","0.34"
"2025-10-23T20:13:12.367Z","On-Demand","claude-4.5-sonnet-thinking","No","146118","1291","11586","634","159629","0.56"
"2025-10-23T20:07:14.793Z","On-Demand","claude-4.5-sonnet-thinking","No","439","2881","154864","743","158927","0.06"
"2025-10-23T20:06:25.467Z","On-Demand","claude-4.5-sonnet-thinking","No","2994","1706","304148","993","309841","0.12"
"2025-10-23T20:05:35.519Z","On-Demand","claude-4.5-sonnet-thinking","No","2570","2812","149284","586","155252","0.07"
"2025-10-23T20:03:37.915Z","On-Demand","claude-4.5-sonnet-thinking","No","1400","3023","147923","913","153259","0.07"
"2025-10-23T20:02:46.081Z","On-Demand","claude-4.5-sonnet-thinking","No","884","1984","147020","674","150562","0.06"
"2025-10-23T20:02:02.412Z","On-Demand","claude-4.5-sonnet-thinking","No","3210","2477","430860","1417","437964","0.17"
"2025-10-23T20:00:42.077Z","On-Demand","claude-4.5-sonnet-thinking","No","790","1959","143088","1423","147260","0.07"
"2025-10-23T19:59:37.067Z","On-Demand","claude-4.5-sonnet-thinking","No","1605","2449","281482","1228","286764","0.11"
"2025-10-23T19:58:01.400Z","On-Demand","claude-4.5-sonnet-thinking","No","2378","1495","278190","700","282763","0.10"
"2025-10-23T19:52:53.162Z","On-Demand","claude-4.5-sonnet-thinking","No","2883","5054","681897","2079","691913","0.26"
"2025-10-23T19:48:09.413Z","On-Demand","claude-4.5-sonnet-thinking","No","124561","17377","1812384","4198","1958520","1.12"
"2025-10-23T19:38:30.889Z","On-Demand","claude-4.5-sonnet-thinking","No","11701","14528","1235529","5455","1267213","0.53"
"2025-10-23T19:36:01.327Z","Errored, Not Charged","claude-4.5-sonnet-thinking","No","10580","11250","1106552","1890","1130272","0.43"
"2025-10-23T19:31:34.317Z","On-Demand","claude-4.5-sonnet-thinking","No","18309","23522","1493811","6056","1541698","0.67"
"2025-10-23T19:29:08.874Z","On-Demand","claude-4.5-sonnet-thinking","No","5403","5918","224116","1390","236827","0.12"
"2025-10-23T19:28:15.804Z","On-Demand","claude-4.5-sonnet-thinking","No","2470","2368","144235","590","149663","0.07"
"2025-10-23T19:25:12.241Z","On-Demand","claude-4.5-sonnet-thinking","No","1864","1901","70095","2329","76189","0.06"
"2025-10-23T19:20:32.263Z","On-Demand","claude-4.5-sonnet-thinking","No","1778","2690","136389","1053","141910","0.07"
"2025-10-23T19:18:07.896Z","On-Demand","claude-4.5-sonnet-thinking","No","2380","1715","65899","1681","71675","0.05"
"2025-10-23T19:17:12.760Z","On-Demand","claude-4.5-sonnet-thinking","No","1143","2875","64688","715","69421","0.04"
"2025-10-23T19:16:01.098Z","On-Demand","claude-4.5-sonnet-thinking","No","53103","3656","72415","1084","130258","0.24"
"2025-10-23T19:07:13.618Z","On-Demand","claude-4.5-sonnet-thinking","No","47618","17427","704691","4980","774716","0.51"
"2025-10-23T18:52:15.529Z","Errored, Not Charged","claude-4.5-sonnet-thinking","No","28742","4160","46300","359","79561","0.14"
"2025-10-23T18:44:58.994Z","On-Demand","claude-4.5-sonnet-thinking","No","2553","2976","337600","1703","344832","0.14"
"2025-10-23T18:41:10.677Z","On-Demand","claude-4.5-sonnet-thinking","No","15930","18217","1587095","7326","1628568","0.69"
"2025-10-23T18:37:14.339Z","On-Demand","claude-4.5-sonnet-thinking","No","3367","3446","298208","2013","307034","0.14"
"2025-10-23T18:29:23.697Z","On-Demand","claude-4.5-sonnet-thinking","No","14920","16767","2379084","5583","2416354","0.90"
"2025-10-23T18:28:09.214Z","On-Demand","claude-4.5-sonnet-thinking","No","2778","2176","263869","1561","270384","0.11"
"2025-10-23T18:27:12.480Z","On-Demand","claude-4.5-sonnet-thinking","No","1955","3351","388722","2405","396433","0.16"
"2025-10-23T18:22:33.847Z","On-Demand","claude-4.5-sonnet-thinking","No","13718","21014","1314121","6090","1354943","0.59"
"2025-10-23T18:20:48.501Z","On-Demand","claude-4.5-sonnet-thinking","No","1522","1693","114420","2364","119999","0.08"
"2025-10-23T18:19:22.942Z","On-Demand","claude-4.5-sonnet-thinking","No","1307","1735","113098","1393","117533","0.06"
"2025-10-23T18:18:32.729Z","On-Demand","claude-4.5-sonnet-thinking","No","3994","3434","325648","913","333989","0.13"
"2025-10-23T18:13:11.271Z","On-Demand","claude-4.5-sonnet-thinking","No","96838","4555","328421","1408","431222","0.49"
"2025-10-23T18:05:34.924Z","On-Demand","claude-4.5-sonnet-thinking","No","2629","3177","100952","1069","107827","0.06"
"2025-10-23T18:00:43.712Z","On-Demand","claude-4.5-sonnet-thinking","No","2006","3074","98938","973","104991","0.06"
"2025-10-23T17:57:50.508Z","On-Demand","claude-4.5-sonnet-thinking","No","87314","2485","11626","954","102379","0.35"
"2025-10-23T17:48:52.042Z","On-Demand","claude-4.5-sonnet-thinking","No","1548","1600","95294","2012","100454","0.06"
"2025-10-23T17:47:07.710Z","On-Demand","claude-4.5-sonnet-thinking","No","83659","1798","11696","1352","98505","0.34"
"2025-10-23T17:34:54.277Z","On-Demand","claude-4.5-sonnet-thinking","No","86015","43987","1825571","16266","1971839","1.23"
"2025-10-23T17:32:43.682Z","On-Demand","claude-4.5-sonnet-thinking","No","5453","792","56770","40","63055","0.04"
"2025-10-23T17:31:24.219Z","On-Demand","claude-4.5-sonnet-thinking","No","0","153221","2294","23591","179106","0.11"
"2025-10-23T17:29:53.365Z","On-Demand","claude-4.5-sonnet-thinking","No","7372","12316","159023","762","179473","0.11"
"2025-10-23T17:24:51.605Z","On-Demand","claude-4.5-sonnet-thinking","No","632","7129","158049","1868","167678","0.09"
"2025-10-23T17:23:08.718Z","On-Demand","claude-4.5-sonnet-thinking","No","13141","8406","604041","1635","627223","0.28"
"2025-10-23T17:22:25.835Z","On-Demand","claude-4.5-sonnet-thinking","No","133224","6580","11569","569","151942","0.53"
"2025-10-23T17:16:21.351Z","On-Demand","claude-4.5-sonnet-thinking","No","132653","7392","289599","802","430446","0.61"
"2025-10-23T17:09:18.796Z","On-Demand","claude-4.5-sonnet-thinking","No","542","6569","131587","427","139125","0.06"
"2025-10-23T17:07:48.173Z","On-Demand","claude-4.5-sonnet-thinking","No","12446","7766","500372","821","521405","0.23"
"2025-10-23T17:05:41.090Z","On-Demand","claude-4.5-sonnet-thinking","No","463","6498","118669","440","126070","0.06"
"2025-10-23T17:04:02.704Z","On-Demand","claude-4.5-sonnet-thinking","No","15226","8854","445007","784","469871","0.23"
"2025-10-23T17:00:15.430Z","On-Demand","claude-4.5-sonnet-thinking","No","7367","8069","96075","512","112023","0.08"
"2025-10-23T16:59:21.757Z","On-Demand","claude-4.5-sonnet-thinking","No","7595","8001","88464","378","104438","0.08"
"2025-10-23T16:55:43.875Z","On-Demand","claude-4.5-sonnet-thinking","No","5993","8130","82518","640","97281","0.08"
"2025-10-23T16:54:08.815Z","On-Demand","claude-4.5-sonnet-thinking","No","6295","6595","76219","555","89664","0.07"
"2025-10-23T16:53:33.025Z","On-Demand","claude-4.5-sonnet-thinking","No","669","6798","75592","853","83912","0.05"
"2025-10-23T16:53:05.103Z","On-Demand","claude-4.5-sonnet-thinking","No","6310","7105","137101","908","151424","0.10"
"2025-10-23T16:50:41.740Z","On-Demand","claude-4.5-sonnet-thinking","No","11490","6933","186338","776","205537","0.13"
"2025-10-23T16:49:54.356Z","On-Demand","claude-4.5-sonnet-thinking","No","547","6240","57163","378","64328","0.04"
"2025-10-23T16:45:51.160Z","On-Demand","claude-4.5-sonnet-thinking","No","45630","2360","174993","906","223889","0.24"
"2025-10-23T16:42:19.473Z","On-Demand","claude-4.5-sonnet-thinking","No","746","6328","165025","452","172551","0.07"
"2025-10-23T16:40:13.472Z","On-Demand","claude-4.5-sonnet-thinking","No","17009","16574","1248336","2906","1284825","0.53"
"2025-10-23T16:35:21.123Z","On-Demand","claude-4.5-sonnet-thinking","No","14018","9643","568166","631","592458","0.26"
"2025-10-23T16:33:18.975Z","On-Demand","claude-4.5-sonnet-thinking","No","7090","6275","128409","361","142135","0.09"
"2025-10-23T16:32:45.005Z","On-Demand","claude-4.5-sonnet-thinking","No","7135","7318","120081","296","134830","0.09"
"2025-10-23T16:30:14.867Z","On-Demand","claude-4.5-sonnet-thinking","No","5687","7742","115572","386","129387","0.08"
"2025-10-23T16:29:06.032Z","On-Demand","claude-4.5-sonnet-thinking","No","6357","6296","109239","456","122348","0.08"
"2025-10-23T16:28:14.221Z","On-Demand","claude-4.5-sonnet-thinking","No","5760","7183","103544","481","116968","0.08"
"2025-10-23T16:25:06.964Z","On-Demand","claude-4.5-sonnet-thinking","No","1045","6355","102450","518","110368","0.06"
"2025-10-23T16:23:18.182Z","On-Demand","claude-4.5-sonnet-thinking","No","16007","12020","574621","1463","604111","0.29"
"2025-10-23T16:19:04.318Z","On-Demand","claude-4.5-sonnet-thinking","No","6326","7096","80097","460","93979","0.07"
"2025-10-23T16:16:41.999Z","On-Demand","claude-4.5-sonnet-thinking","No","6797","7035","73304","351","87487","0.07"
"2025-10-23T16:14:48.430Z","On-Demand","claude-4.5-sonnet-thinking","No","7273","7399","66008","389","81069","0.07"
"2025-10-23T16:13:29.262Z","On-Demand","claude-4.5-sonnet-thinking","No","7282","7841","58754","507","74384","0.07"
"2025-10-23T16:12:28.627Z","On-Demand","claude-4.5-sonnet-thinking","No","7309","7851","51435","484","67079","0.07"
"2025-10-23T16:10:16.557Z","On-Demand","claude-4.5-sonnet-thinking","No","332","7870","51116","531","59849","0.04"
"2025-10-23T16:06:53.441Z","On-Demand","claude-4.5-sonnet-thinking","No","39559","145087","11522","21057","217225","0.25"
"2025-10-23T16:04:13.908Z","On-Demand","claude-4.5-sonnet-thinking","No","7051","7824","158107","464","173446","0.10"
"2025-10-23T16:02:34.403Z","Errored, Not Charged","claude-4.5-sonnet-thinking","No","0","712","668","10","1390","0.000"
"2025-10-23T16:01:16.587Z","On-Demand","claude-4.5-sonnet-thinking","No","7163","6476","145146","588","159373","0.09"
"2025-10-23T15:58:08.964Z","On-Demand","claude-4.5-sonnet-thinking","No","5524","7779","139561","383","153247","0.09"
"2025-10-23T15:57:09.085Z","On-Demand","claude-4.5-sonnet-thinking","No","5651","6212","133902","289","146054","0.08"
"2025-10-23T15:56:03.439Z","On-Demand","claude-4.5-sonnet-thinking","No","5728","6270","128199","420","140617","0.08"
"2025-10-23T15:55:27.192Z","On-Demand","claude-4.5-sonnet-thinking","No","5364","6399","122799","282","134844","0.08"
"2025-10-23T15:50:58.374Z","On-Demand","claude-4.5-sonnet-thinking","No","2579","6108","119609","171","128467","0.06"
"2025-10-23T15:48:47.275Z","On-Demand","claude-4.5-sonnet-thinking","No","110419","10599","830305","2634","953957","0.73"
"2025-10-23T15:41:33.374Z","On-Demand","claude-4.5-sonnet-thinking","No","100821","34050","1928933","4988","2068792","1.13"
"2025-10-23T15:05:41.999Z","On-Demand","claude-4.5-sonnet-thinking","No","6555","6564","234394","510","248023","0.12"
"2025-10-23T15:03:57.869Z","On-Demand","claude-4.5-sonnet-thinking","No","17387","12908","846076","2113","878484","0.38"
"2025-10-23T15:03:18.831Z","On-Demand","claude-4.5-sonnet-thinking","No","9710","7692","50072","442","67916","0.08"
"2025-10-23T14:55:49.945Z","Errored, Not Charged","claude-4.5-sonnet-thinking","No","55123","23055","710643","5156","793977","0.56"
"2025-10-23T14:53:51.896Z","On-Demand","claude-4.5-sonnet-thinking","No","8232","8954","476332","1911","495429","0.23"
"2025-10-23T14:48:30.976Z","On-Demand","claude-4.5-sonnet-thinking","No","146227","9528","467395","1474","624624","0.74"
"2025-10-23T14:43:01.715Z","On-Demand","claude-4.5-sonnet-thinking","No","24482","20205","2520608","4259","2569554","0.97"
"2025-10-23T14:41:41.332Z","On-Demand","claude-4.5-sonnet-thinking","No","898","7740","123590","569","132797","0.07"
"2025-10-23T14:38:11.118Z","On-Demand","claude-4.5-sonnet-thinking","No","9258","8791","349674","1248","368971","0.18"
"2025-10-23T14:37:02.188Z","On-Demand","claude-4.5-sonnet-thinking","No","6053","7832","215472","724","230081","0.12"
"2025-10-23T14:34:35.266Z","On-Demand","claude-4.5-sonnet-thinking","No","13731","7895","510753","1447","533826","0.25"
"2025-10-23T14:31:04.052Z","On-Demand","claude-4.5-sonnet-thinking","No","663","7880","93905","653","103101","0.06"
"2025-10-23T14:25:18.611Z","On-Demand","claude-4.5-sonnet-thinking","No","8586","12408","529875","1189","552058","0.24"
"2025-10-23T14:24:53.347Z","Errored, Not Charged","claude-4.5-sonnet-thinking","No","0","745","1180","15","1940","0.000"
"2025-10-23T14:22:54.793Z","On-Demand","claude-4.5-sonnet-thinking","No","17828","17140","535795","1601","572364","0.30"
"2025-10-23T14:19:17.616Z","On-Demand","claude-4.5-sonnet-thinking","No","717","7009","65977","301","74004","0.04"
"2025-10-23T14:17:00.100Z","On-Demand","claude-4.5-sonnet-thinking","No","54453","7055","69956","725","132189","0.25"
"2025-10-23T14:07:51.829Z","On-Demand","claude-4.5-sonnet-thinking","No","772","3249","56849","419","61289","0.03"
"2025-10-23T14:04:56.610Z","On-Demand","claude-4.5-sonnet-thinking","No","4025","5945","265430","1404","276804","0.13"
"2025-10-23T14:04:19.636Z","On-Demand","claude-4.5-sonnet-thinking","No","1391","1260","102194","441","105286","0.04"
"2025-10-23T14:03:38.802Z","On-Demand","claude-4.5-sonnet-thinking","No","39881","1822","11553","444","53700","0.16"
"2025-10-23T13:57:45.078Z","On-Demand","claude-4.5-sonnet-thinking","No","3334","3533","142182","662","149711","0.07"
"2025-10-23T13:55:01.527Z","On-Demand","claude-4.5-sonnet-thinking","No","1183","1315","46570","508","49576","0.03"
"2025-10-23T13:51:45.679Z","On-Demand","claude-4.5-sonnet-thinking","No","4857","7153","339010","1738","352758","0.16"
"2025-10-23T13:51:09.212Z","On-Demand","claude-4.5-sonnet-thinking","No","807","1523","40892","388","43610","0.02"
"2025-10-23T13:50:24.660Z","On-Demand","claude-4.5-sonnet-thinking","No","873","2027","117856","506","121262","0.05"
"2025-10-23T13:45:59.539Z","Errored, Not Charged","claude-4.5-sonnet-thinking","No","28460","2798","160669","1122","193049","0.18"
"2025-10-23T13:41:30.141Z","On-Demand","claude-4.5-sonnet-thinking","No","700","3932","174492","803","179927","0.07"
"2025-10-23T13:38:43.618Z","On-Demand","claude-4.5-sonnet-thinking","No","9645","1665","164685","467","176462","0.09"
"2025-10-23T13:31:21.843Z","On-Demand","claude-4.5-sonnet-thinking","No","13124","16834","2113428","3457","2146843","0.78"
"2025-10-23T13:30:26.057Z","On-Demand","claude-4.5-sonnet-thinking","No","3239","1042","156736","132","161149","0.06"
"2025-10-23T13:25:45.484Z","On-Demand","claude-4.5-sonnet-thinking","No","8042","7317","1389255","2114","1406728","0.50"
"2025-10-23T13:22:23.504Z","On-Demand","claude-4.5-sonnet-thinking","No","5900","8916","1194451","1848","1211115","0.43"
"2025-10-23T13:20:09.335Z","On-Demand","claude-4.5-sonnet-thinking","No","6407","2764","433479","912","443562","0.17"
"2025-10-23T13:17:16.757Z","On-Demand","claude-4.5-sonnet-thinking","No","5699","8568","1131380","1322","1146969","0.40"
"2025-10-23T13:15:36.486Z","On-Demand","claude-4.5-sonnet-thinking","No","3438","3512","412523","1317","420790","0.16"
"2025-10-23T13:12:12.276Z","On-Demand","claude-4.5-sonnet-thinking","No","4474","6100","536147","1831","548552","0.22"
"2025-10-23T13:09:25.338Z","On-Demand","claude-4.5-sonnet-thinking","No","121583","1417","11616","731","135347","0.47"
"2025-10-23T13:05:35.185Z","On-Demand","claude-4.5-sonnet-thinking","No","10611","12713","1997289","3748","2024361","0.73"
"2025-10-23T12:59:44.937Z","On-Demand","claude-4.5-sonnet-thinking","No","110260","12446","693935","3787","820428","0.71"
"2025-10-23T12:44:54.249Z","On-Demand","claude-4.5-sonnet-thinking","No","2072","2849","108256","715","113892","0.06"
"2025-10-23T12:42:36.031Z","On-Demand","claude-4.5-sonnet-thinking","No","864","2612","107393","755","111624","0.05"
"2025-10-23T12:40:28.898Z","On-Demand","claude-4.5-sonnet-thinking","No","1804","2191","314900","1084","319979","0.12"
"2025-10-23T12:38:06.113Z","On-Demand","claude-4.5-sonnet-thinking","No","2706","3380","204672","801","211559","0.09"
"2025-10-23T12:33:49.168Z","On-Demand","claude-4.5-sonnet-thinking","No","2002","1305","100178","587","104072","0.05"
"2025-10-23T12:30:11.034Z","On-Demand","claude-4.5-sonnet-thinking","No","89272","6352","306103","1378","403105","0.46"
"2025-10-23T12:24:09.289Z","On-Demand","claude-4.5-sonnet-thinking","No","1636","2717","191656","948","196957","0.08"
"2025-10-23T12:20:44.553Z","On-Demand","claude-4.5-sonnet-thinking","No","3917","4227","465108","1195","474447","0.18"
"2025-10-23T12:15:05.573Z","On-Demand","claude-4.5-sonnet-thinking","No","4894","4982","353690","1207","364773","0.15"
"2025-10-23T12:13:47.223Z","On-Demand","claude-4.5-sonnet-thinking","No","948","2082","172343","1184","176557","0.07"
"2025-10-23T12:08:37.323Z","On-Demand","claude-4.5-sonnet-thinking","No","593","1259","86156","488","88496","0.04"
"2025-10-23T12:02:34.897Z","On-Demand","claude-4.5-sonnet-thinking","No","5628","6129","407942","1442","421141","0.18"
"2025-10-23T11:57:42.934Z","On-Demand","claude-4.5-sonnet-thinking","No","3184","7577","231234","852","242847","0.10"
"2025-10-23T11:55:05.510Z","On-Demand","claude-4.5-sonnet-thinking","No","5429","5470","432012","3786","446697","0.22"
"2025-10-23T11:52:23.338Z","On-Demand","claude-4.5-sonnet-thinking","No","2649","3459","275985","1706","283799","0.12"
"2025-10-23T11:48:50.077Z","On-Demand","claude-4.5-sonnet-thinking","No","4263","7000","320255","4332","335850","0.19"
"2025-10-23T11:46:20.584Z","On-Demand","claude-4.5-sonnet-thinking","No","3144","8888","185216","816","198064","0.09"
"2025-10-23T11:44:35.364Z","On-Demand","claude-4.5-sonnet-thinking","No","14970","16511","491829","2555","525865","0.27"
"2025-10-23T11:40:58.166Z","On-Demand","claude-4.5-sonnet-thinking","No","44481","179318","1825042","29177","2078018","0.99"
"2025-10-23T11:39:17.675Z","On-Demand","claude-4.5-sonnet-thinking","No","3327","3362","643998","1629","652316","0.23"
"2025-10-23T11:29:38.529Z","On-Demand","claude-4.5-sonnet-thinking","No","149227","40846","3571221","25406","3786700","2.12"
"2025-10-23T11:21:31.557Z","On-Demand","claude-4.5-sonnet-thinking","No","114426","23082","112994","419","250921","0.54"
"2025-10-23T11:01:21.346Z","On-Demand","claude-4.5-sonnet-thinking","No","65663","29737","304181","1180","400761","0.44"
"2025-10-23T10:59:52.953Z","On-Demand","claude-4.5-sonnet-thinking","No","155109","29849","152915","756","338629","0.71"
"2025-10-23T10:53:15.599Z","On-Demand","claude-4.5-sonnet-thinking","No","957","24682","117604","620","143863","0.12"
"2025-10-23T10:47:58.952Z","On-Demand","claude-4.5-sonnet-thinking","No","104005","25771","332815","1486","464077","0.58"
"2025-10-23T10:44:07.076Z","On-Demand","claude-4.5-sonnet-thinking","No","80996","23081","170603","1051","275731","0.44"
"2025-10-23T10:36:52.979Z","On-Demand","claude-4.5-sonnet-thinking","No","56296","1262","81558","769","139885","0.25"
"2025-10-23T10:35:20.525Z","On-Demand","claude-4.5-sonnet-thinking","No","913","22149","132590","453","156105","0.11"
"2025-10-23T10:32:34.131Z","On-Demand","claude-4.5-sonnet-thinking","No","23532","24209","217131","781","265653","0.23"
"2025-10-23T10:30:44.556Z","On-Demand","claude-4.5-sonnet-thinking","No","44479","24137","149142","715","218473","0.29"
"2025-10-23T10:26:28.356Z","On-Demand","claude-4.5-sonnet-thinking","No","755","22407","63832","565","87559","0.09"
"2025-10-23T10:24:03.966Z","On-Demand","claude-4.5-sonnet-thinking","No","50253","1627","75363","756","127999","0.22"
"2025-10-23T10:23:08.840Z","On-Demand","claude-4.5-sonnet-thinking","No","943","23565","130009","492","155009","0.12"
"2025-10-23T10:21:40.889Z","On-Demand","claude-4.5-sonnet-thinking","No","45064","23741","190949","907","260661","0.31"
"2025-10-23T10:17:41.060Z","On-Demand","claude-4.5-sonnet-thinking","No","24884","23444","60051","451","108830","0.18"
"2025-10-23T10:11:33.811Z","On-Demand","claude-4.5-sonnet-thinking","No","48508","158198","11601","22062","240369","0.36"
"2025-10-23T10:11:16.902Z","On-Demand","claude-4.5-sonnet-thinking","No","0","724","670","10","1404","0.000"
"2025-10-23T10:06:26.590Z","On-Demand","claude-4.5-sonnet-thinking","No","152954","22687","153139","867","329647","0.70"
"2025-10-23T09:59:55.076Z","On-Demand","claude-4.5-sonnet-thinking","No","22529","23607","97851","529","144516","0.19"
"2025-10-23T09:56:38.012Z","On-Demand","claude-4.5-sonnet-thinking","No","22287","23105","75547","484","121423","0.18"
"2025-10-23T09:53:53.955Z","On-Demand","claude-4.5-sonnet-thinking","No","1260","22839","74307","583","98989","0.10"
"2025-10-23T09:50:35.357Z","On-Demand","claude-4.5-sonnet-thinking","No","62738","5169","228248","1001","297156","0.32"
"2025-10-23T09:46:32.625Z","Errored, Not Charged","claude-4.5-sonnet-thinking","No","24894","24883","754293","1148","805218","0.41"
"2025-10-23T09:42:55.525Z","On-Demand","claude-4.5-sonnet-thinking","No","44595","23693","207172","632","276092","0.31"
"2025-10-23T09:40:21.775Z","On-Demand","claude-4.5-sonnet-thinking","No","24599","22783","68834","734","116950","0.19"
"2025-10-23T09:38:51.074Z","On-Demand","claude-4.5-sonnet-thinking","No","24158","25784","404179","1216","455337","0.30"
"2025-10-23T09:36:45.780Z","On-Demand","claude-4.5-sonnet-thinking","No","56402","2369","207848","1315","267934","0.30"
"2025-10-23T09:33:05.120Z","On-Demand","claude-4.5-sonnet-thinking","No","868","24147","141229","1029","167273","0.13"
"2025-10-23T09:29:42.602Z","On-Demand","claude-4.5-sonnet-thinking","No","24162","25452","783046","1720","834380","0.42"
"2025-10-23T09:28:16.897Z","On-Demand","claude-4.5-sonnet-thinking","No","105407","33288","875415","2903","1017013","0.80"
"2025-10-23T09:22:29.238Z","Errored, Not Charged","claude-4.5-sonnet-thinking","No","76145","27899","661863","1766","767673","0.59"
"2025-10-23T09:19:37.673Z","On-Demand","claude-4.5-sonnet-thinking","No","53378","27505","983305","1911","1066099","0.60"
"2025-10-23T09:16:54.573Z","On-Demand","claude-4.5-sonnet-thinking","No","28823","28764","942930","2774","1003291","0.51"
"2025-10-23T09:12:43.667Z","On-Demand","claude-4.5-sonnet-thinking","No","30515","10546","737533","3634","782228","0.41"
"2025-10-23T09:08:40.937Z","On-Demand","claude-4.5-sonnet-thinking","No","57375","1520","11666","2026","72587","0.25"
"2025-10-23T09:04:47.724Z","On-Demand","claude-4.5-sonnet-thinking","No","23027","26302","582891","1635","633855","0.36"
"2025-10-23T09:02:37.464Z","On-Demand","claude-4.5-sonnet-thinking","No","21828","22581","226242","640","271291","0.22"
"2025-10-23T09:01:26.457Z","On-Demand","claude-4.5-sonnet-thinking","No","28459","25799","395336","1116","450710","0.32"
"2025-10-23T08:57:40.224Z","On-Demand","claude-4.5-sonnet-thinking","No","77360","163809","665856","25324","932349","0.70"
"2025-10-23T08:54:37.487Z","On-Demand","claude-4.5-sonnet-thinking","No","158570","23932","492651","987","676140","0.83"
"2025-10-23T08:49:29.731Z","On-Demand","claude-4.5-sonnet-thinking","No","50948","32717","1212231","3356","1299252","0.69"
"2025-10-23T08:45:55.072Z","On-Demand","claude-4.5-sonnet-thinking","No","686","22746","95235","1986","120653","0.12"
"2025-10-23T08:41:38.573Z","On-Demand","claude-4.5-sonnet-thinking","No","26342","26952","411010","1863","466167","0.33"
"2025-10-23T08:40:11.411Z","On-Demand","claude-4.5-sonnet-thinking","No","55206","1417","80430","545","137598","0.24"
"2025-10-23T08:38:30.585Z","On-Demand","claude-4.5-sonnet-thinking","No","26881","25382","573530","1050","626843","0.36"
"2025-10-23T08:34:08.178Z","On-Demand","claude-4.5-sonnet-thinking","No","48094","26308","581534","1449","657385","0.45"
"2025-10-23T08:32:38.555Z","On-Demand","claude-4.5-sonnet-thinking","No","263","23629","84855","343","109090","0.10"
"2025-10-23T08:31:16.717Z","On-Demand","claude-4.5-sonnet-thinking","No","21126","924","63716","284","86050","0.10"
"2025-10-23T08:30:29.134Z","On-Demand","claude-4.5-sonnet-thinking","No","50196","846","13466","47","64555","0.19"
"2025-10-23T08:28:46.158Z","On-Demand","claude-4.5-sonnet-thinking","No","50227","28842","831685","1295","912049","0.54"
"2025-10-23T08:27:39.636Z","On-Demand","claude-4.5-sonnet-thinking","No","22310","23848","81707","737","128602","0.19"
"2025-10-23T08:25:58.336Z","On-Demand","claude-4.5-sonnet-thinking","No","890","22853","80795","604","105142","0.10"
"2025-10-23T08:19:11.952Z","Errored, Not Charged","claude-4.5-sonnet-thinking","No","69222","22663","69358","783","162026","0.36"
"2025-10-23T08:18:09.026Z","On-Demand","claude-4.5-sonnet-thinking","No","158437","23292","325749","731","508209","0.77"
"2025-10-23T08:05:42.799Z","Errored, Not Charged","claude-4.5-sonnet-thinking","No","133683","75369","9275183","19369","9503604","3.79"
"2025-10-23T07:58:57.576Z","On-Demand","claude-4.5-sonnet-thinking","No","141624","49738","3209230","17676","3418268","1.90"
"2025-10-23T07:47:41.312Z","On-Demand","claude-4.5-sonnet-thinking","No","96954","82466","4234695","24450","4438565","2.24"
"2025-10-23T07:46:31.032Z","On-Demand","claude-4.5-sonnet-thinking","No","26334","21254","126848","2312","176748","0.23"
"2025-10-23T07:45:08.357Z","Errored, Not Charged","claude-4.5-sonnet-thinking","No","874","26804","125568","2738","155984","0.15"
"2025-10-23T07:41:39.351Z","On-Demand","claude-4.5-sonnet-thinking","No","114338","21637","115389","1204","252568","0.54"
"2025-10-23T07:32:33.277Z","Errored, Not Charged","claude-4.5-sonnet-thinking","No","92428","40465","1799025","6287","1938205","1.10"
"2025-10-23T07:27:32.549Z","On-Demand","claude-4.5-sonnet-thinking","No","31212","35298","2508944","3629","2579083","1.02"
"2025-10-23T07:27:07.099Z","On-Demand","claude-4.5-sonnet-thinking","No","124470","20797","125245","442","270954","0.57"
"2025-10-23T07:20:27.452Z","Errored, Not Charged","claude-4.5-sonnet-thinking","No","102477","57475","2163677","8934","2332563","1.33"
"2025-10-23T07:17:51.222Z","On-Demand","claude-4.5-sonnet-thinking","No","25673","26209","973070","1879","1026831","0.49"
"2025-10-23T07:14:08.300Z","On-Demand","claude-4.5-sonnet-thinking","No","135744","33186","1697118","3489","1869537","1.16"
"2025-10-23T07:10:59.083Z","On-Demand","claude-4.5-sonnet-thinking","No","40073","47648","1651897","5008","1744626","0.86"
"2025-10-23T07:06:02.899Z","On-Demand","claude-4.5-sonnet-thinking","No","64349","8441","967236","2689","1042715","0.59"
"2025-10-23T07:04:25.438Z","On-Demand","claude-4.5-sonnet-thinking","No","26299","27143","411116","427","464985","0.31"
"2025-10-23T07:02:25.661Z","On-Demand","claude-4.5-sonnet-thinking","No","26619","27347","331787","494","386247","0.29"
"2025-10-23T07:00:53.198Z","On-Demand","claude-4.5-sonnet-thinking","No","26179","27426","252556","428","306589","0.26"
"2025-10-23T06:59:38.281Z","On-Demand","claude-4.5-sonnet-thinking","No","62974","2198","235512","939","301623","0.32"
"2025-10-23T06:54:47.760Z","On-Demand","claude-4.5-sonnet-thinking","No","149073","42115","3371216","6711","3569115","1.79"
"2025-10-23T06:44:47.930Z","On-Demand","claude-4.5-sonnet-thinking","No","27649","28052","310634","525","366860","0.29"
"2025-10-23T06:40:33.562Z","Errored, Not Charged","claude-4.5-sonnet-thinking","No","82456","34172","262281","2104","381013","0.51"
"2025-10-23T06:38:18.639Z","On-Demand","claude-4.5-sonnet-thinking","No","27287","28251","237573","610","293721","0.26"
"2025-10-23T06:36:13.418Z","On-Demand","claude-4.5-sonnet-thinking","No","107929","41624","429826","5680","585059","0.73"
"2025-10-23T06:27:03.842Z","On-Demand","claude-4.5-sonnet-thinking","No","69133","2886","245953","1103","319075","0.35"
"2025-10-23T06:25:08.662Z","On-Demand","claude-4.5-sonnet-thinking","No","28442","28753","693624","704","751523","0.41"
"2025-10-23T06:19:48.349Z","On-Demand","claude-4.5-sonnet-thinking","No","31260","30164","306743","1419","369586","0.32"
"2025-10-23T06:11:44.881Z","On-Demand","claude-4.5-sonnet-thinking","No","83432","167105","440711","31104","722352","0.67"
"2025-10-23T06:10:25.521Z","On-Demand","claude-4.5-sonnet-thinking","No","20064","20567","453914","648","495193","0.28"
"2025-10-23T06:08:04.935Z","On-Demand","claude-4.5-sonnet-thinking","No","24983","28486","526580","880","580929","0.34"
"2025-10-23T06:06:50.773Z","Errored, Not Charged","claude-4.5-sonnet-thinking","No","20849","24228","197998","3790","246865","0.26"
"2025-10-23T06:01:57.520Z","On-Demand","claude-4.5-sonnet-thinking","No","14339","18296","169915","473","203023","0.15"
"2025-10-23T05:57:51.087Z","On-Demand","claude-4.5-sonnet-thinking","No","13362","13858","142282","313","169815","0.14"
"2025-10-23T05:54:31.603Z","On-Demand","claude-4.5-sonnet-thinking","No","60637","146318","204238","29136","440329","0.48"
"2025-10-23T05:52:55.886Z","On-Demand","claude-4.5-sonnet-thinking","No","13736","14471","460836","526","489569","0.24"
"2025-10-23T05:51:45.590Z","On-Demand","claude-4.5-sonnet-thinking","No","12927","13504","569928","456","596815","0.26"
"2025-10-23T05:49:18.263Z","On-Demand","claude-4.5-sonnet-thinking","No","125909","25535","1185114","3400","1339958","0.94"
"2025-10-23T05:38:16.014Z","On-Demand","claude-4.5-sonnet-thinking","No","15854","15362","85196","164","116576","0.13"
"2025-10-23T05:37:37.820Z","On-Demand","claude-4.5-sonnet-thinking","No","2881","16599","82341","2344","104165","0.12"
"2025-10-23T05:33:50.095Z","On-Demand","claude-4.5-sonnet-thinking","No","16439","16993","214993","3034","251459","0.22"
"2025-10-23T05:28:22.957Z","Errored, Not Charged","claude-4.5-sonnet-thinking","No","54979","15830","187315","6046","264170","0.39"
"2025-10-23T05:24:54.172Z","On-Demand","claude-4.5-sonnet-thinking","No","277","7765","166770","90","174902","0.07"
"2025-10-23T05:23:37.354Z","On-Demand","claude-4.5-sonnet-thinking","No","7595","7886","317395","275","333151","0.15"
"2025-10-23T05:19:35.513Z","On-Demand","claude-4.5-sonnet-thinking","No","147708","31648","2424614","6124","2610094","1.46"
"2025-10-23T05:13:59.826Z","On-Demand","claude-4.5-sonnet-thinking","No","8440","8813","124252","1199","142704","0.11"
"2025-10-23T05:12:51.107Z","On-Demand","claude-4.5-sonnet-thinking","No","112595","8858","11663","1161","134277","0.46"
"2025-10-23T00:01:35.401Z","On-Demand","claude-4.5-sonnet-thinking","No","9376","10140","347674","591","367781","0.17"
"2025-10-23T00:00:21.542Z","On-Demand","claude-4.5-sonnet-thinking","No","102527","4375","231839","652","339393","0.47"
"2025-10-22T23:59:12.041Z","On-Demand","claude-4.5-sonnet-thinking","No","3078","3919","429408","619","437024","0.16"
"2025-10-22T23:57:12.763Z","On-Demand","claude-4.5-sonnet-thinking","No","10941","13915","1011474","2324","1038654","0.42"
"2025-10-22T23:55:46.088Z","On-Demand","claude-4.5-sonnet-thinking","No","3829","5137","278541","889","288396","0.12"
"2025-10-22T23:53:20.887Z","On-Demand","claude-4.5-sonnet-thinking","No","5499","5946","352349","1144","364938","0.16"
"2025-10-22T23:51:55.051Z","On-Demand","claude-4.5-sonnet-thinking","No","75714","5584","347457","1239","429994","0.42"
"2025-10-22T23:50:23.269Z","On-Demand","claude-4.5-sonnet-thinking","No","71558","10367","634208","2051","718184","0.52"
"2025-10-22T23:42:46.821Z","Errored, Not Charged","claude-4.5-sonnet-thinking","No","114307","51589","3149184","9955","3325035","1.67"
"2025-10-22T23:40:51.010Z","On-Demand","claude-4.5-sonnet-thinking","No","7129","8849","1137047","3672","1156697","0.45"
"2025-10-22T23:40:14.177Z","On-Demand","claude-4.5-sonnet-thinking","No","318","1794","160740","349","163201","0.06"
"2025-10-22T23:39:08.650Z","On-Demand","claude-4.5-sonnet-thinking","No","4206","3867","628633","997","637703","0.23"
"2025-10-22T23:34:04.505Z","On-Demand","claude-4.5-sonnet-thinking","No","9683","11205","897353","1814","920055","0.36"
"2025-10-22T23:30:50.636Z","On-Demand","claude-4.5-sonnet-thinking","No","1594","3865","289388","1353","296200","0.12"
"2025-10-22T23:27:28.961Z","On-Demand","claude-4.5-sonnet-thinking","No","4502","5100","847053","2256","858911","0.32"
"2025-10-22T23:25:59.228Z","On-Demand","claude-4.5-sonnet-thinking","No","6720","8278","809978","2293","827269","0.32"
"2025-10-22T23:22:24.557Z","On-Demand","claude-4.5-sonnet-thinking","No","9406","7609","634773","3761","655549","0.30"
"2025-10-22T23:20:53.072Z","On-Demand","claude-4.5-sonnet-thinking","No","1252","6388","368913","1065","377618","0.15"
"2025-10-22T23:19:16.147Z","On-Demand","claude-4.5-sonnet-thinking","No","3697","5361","477716","1869","488643","0.20"
"2025-10-22T23:17:20.691Z","On-Demand","claude-4.5-sonnet-thinking","No","7319","11501","910790","2437","932047","0.37"
"2025-10-22T23:14:55.812Z","On-Demand","claude-4.5-sonnet-thinking","No","10094","11152","836207","3998","861451","0.38"
"2025-10-22T23:12:56.053Z","On-Demand","claude-4.5-sonnet-thinking","No","3140","4392","296698","697","304927","0.12"
"2025-10-22T23:12:00.902Z","On-Demand","claude-4.5-sonnet-thinking","No","6259","3699","379996","703","390657","0.16"
"2025-10-22T23:09:43.708Z","On-Demand","claude-4.5-sonnet-thinking","No","5474","6413","459543","1169","472599","0.19"
"2025-10-22T23:08:35.645Z","On-Demand","claude-4.5-sonnet-thinking","No","4779","4527","261396","1010","271712","0.12"
"2025-10-22T23:07:03.548Z","On-Demand","claude-4.5-sonnet-thinking","No","4393","5086","497336","1252","508067","0.20"
"2025-10-22T23:05:06.877Z","On-Demand","claude-4.5-sonnet-thinking","No","26334","13405","662383","3067","705189","0.38"
"2025-10-22T23:00:36.943Z","On-Demand","claude-4.5-sonnet-thinking","No","14468","17392","340354","2573","374787","0.24"
"2025-10-22T22:58:56.473Z","On-Demand","claude-4.5-sonnet-thinking","No","3729","4235","201866","816","210646","0.10"
"2025-10-22T22:54:29.856Z","On-Demand","claude-4.5-sonnet-thinking","No","38716","142437","249815","31407","462375","0.37"
"2025-10-22T22:53:52.322Z","On-Demand","claude-4.5-sonnet-thinking","No","1067","1607","173704","190","176568","0.06"
"2025-10-22T22:53:29.764Z","On-Demand","claude-4.5-sonnet-thinking","No","511","1706","173240","382","175839","0.06"
"2025-10-22T22:50:47.344Z","On-Demand","claude-4.5-sonnet-thinking","No","9979","14290","2495307","3491","2523067","0.88"
"2025-10-22T22:47:25.419Z","On-Demand","claude-4.5-sonnet-thinking","No","9539","12783","2040077","3266","2065665","0.73"
"2025-10-22T22:45:42.761Z","On-Demand","claude-4.5-sonnet-thinking","No","1788","2571","605651","679","610689","0.20"
"2025-10-22T22:44:55.453Z","On-Demand","claude-4.5-sonnet-thinking","No","2001","2382","448765","742","453890","0.16"
"2025-10-22T22:40:49.773Z","On-Demand","claude-4.5-sonnet-thinking","No","11111","13484","1995970","5012","2025577","0.75"
"2025-10-22T22:37:57.635Z","On-Demand","claude-4.5-sonnet-thinking","No","4965","5113","943092","1473","954643","0.33"
"2025-10-22T22:34:13.044Z","On-Demand","claude-4.5-sonnet-thinking","No","3756","4558","521819","639","530772","0.19"
"2025-10-22T22:32:55.399Z","On-Demand","claude-4.5-sonnet-thinking","No","1199","1790","128926","517","132432","0.05"
"2025-10-22T22:32:02.032Z","On-Demand","claude-4.5-sonnet-thinking","No","2964","3760","376964","747","384435","0.14"
"2025-10-22T22:31:05.287Z","On-Demand","claude-4.5-sonnet-thinking","No","2036","2479","247181","521","252217","0.09"
"2025-10-22T22:30:37.280Z","On-Demand","claude-4.5-sonnet-thinking","No","1049","1790","122874","523","126236","0.05"
"2025-10-22T22:28:25.543Z","On-Demand","claude-4.5-sonnet-thinking","No","2274","2960","721885","1110","728229","0.25"
"2025-10-22T22:27:07.264Z","On-Demand","claude-4.5-sonnet-thinking","No","2932","4354","706045","1244","714575","0.25"
"2025-10-22T22:24:19.150Z","On-Demand","claude-4.5-sonnet-thinking","No","1631","2371","346063","455","350520","0.12"
"2025-10-22T22:18:26.382Z","On-Demand","claude-4.5-sonnet-thinking","No","28652","28467","261890","906","319915","0.28"
"2025-10-22T22:17:25.056Z","On-Demand","claude-4.5-sonnet-thinking","No","75821","2390","96602","1523","176336","0.34"
"2025-10-22T22:13:02.722Z","On-Demand","claude-4.5-sonnet-thinking","No","72162","21172","1539627","8025","1640986","0.91"
"2025-10-22T22:04:45.403Z","Errored, Not Charged","claude-4.5-sonnet-thinking","No","219950","20816","2832781","7554","3081101","1.84"
"2025-10-22T21:58:20.789Z","On-Demand","claude-4.5-sonnet-thinking","No","22506","18637","2125628","6227","2172998","0.86"
"2025-10-22T21:51:51.354Z","On-Demand","claude-4.5-sonnet-thinking","No","12843","17811","1659987","5832","1696473","0.68"
"2025-10-22T21:48:50.201Z","On-Demand","claude-4.5-sonnet-thinking","No","11884","13350","1523864","4338","1553436","0.60"
"2025-10-22T21:44:58.991Z","On-Demand","claude-4.5-sonnet-thinking","No","110806","11684","822447","3332","948269","0.74"
"2025-10-22T21:22:44.278Z","On-Demand","claude-4.5-sonnet-thinking","No","102444","127965","9708644","26776","9965829","4.07"
"2025-10-22T21:20:00.851Z","On-Demand","claude-4.5-sonnet-thinking","No","9003","11660","1328209","5752","1354624","0.55"
"2025-10-22T21:17:16.899Z","On-Demand","claude-4.5-sonnet-thinking","No","26872","9517","1238868","4540","1279797","0.56"
"2025-10-22T21:12:33.306Z","On-Demand","claude-4.5-sonnet-thinking","No","5179","26679","797204","4367","833429","0.40"
"2025-10-22T21:07:39.274Z","On-Demand","claude-4.5-sonnet-thinking","No","32386","32300","691301","1806","757793","0.45"
"2025-10-22T21:02:26.937Z","On-Demand","claude-4.5-sonnet-thinking","No","19436","22269","2208178","8427","2258310","0.92"
"2025-10-22T20:59:33.648Z","On-Demand","claude-4.5-sonnet-thinking","No","71937","3000","173299","720","248956","0.34"
"2025-10-22T20:23:09.557Z","Included","auto","No","0","43401","1260056","6335","1309792","0.41"
"2025-10-22T20:08:54.887Z","Errored, Not Charged","auto","No","0","67513","748421","5160","821094","0.30"
"2025-10-22T20:03:06.891Z","Included","auto","No","0","8014","655692","445","664151","0.18"
"2025-10-22T20:02:16.543Z","Included","auto","No","0","4466","215351","166","219983","0.06"
"2025-10-22T20:01:20.162Z","Included","auto","No","0","28262","191664","248","220174","0.08"
"2025-10-22T19:52:29.237Z","Included","auto","No","0","102813","1475688","2353","1580854","0.51"
"2025-10-22T19:08:46.831Z","Included","auto","No","0","26624","1732401","2253","1761278","0.48"
"2025-10-22T19:05:10.192Z","Included","auto","No","0","91753","3504459","5334","3601546","1.02"
"2025-10-22T18:53:55.797Z","Included","auto","No","0","3809","70582","40","74431","0.02"
"2025-10-22T18:53:24.090Z","Included","auto","No","0","6984","67144","322","74450","0.03"
"2025-10-22T18:52:44.131Z","Included","auto","No","0","8097","488235","605","496937","0.14"
"2025-10-22T18:06:20.550Z","Errored, Not Charged","auto","No","0","303572","2584028","12352","2899952","1.10"
"2025-10-22T17:54:35.359Z","Included","auto","No","0","78353","1331689","1792","1411834","0.44"
"2025-10-22T17:47:27.465Z","Included","auto","No","0","22328","1567589","2559","1592476","0.44"
"2025-10-22T17:43:48.947Z","Included","auto","No","0","28749","912188","2163","943100","0.28"
"2025-10-22T17:32:47.071Z","Included","auto","No","0","126589","183207","265","310061","0.21"
"2025-10-22T17:27:27.959Z","Included","auto","No","0","102893","9342","1180","113415","0.14"
"2025-10-22T16:58:09.135Z","Included","auto","No","0","66931","67708","98","134737","0.10"
"2025-10-22T16:56:46.755Z","Included","auto","No","0","155254","69515","2763","227532","0.23"
"2025-10-22T16:03:26.979Z","Included","auto","No","0","49888","483836","1065","534789","0.19"
"2025-10-22T16:02:15.665Z","Included","auto","No","0","48343","61691","370","110404","0.08"
"2025-10-22T15:40:13.397Z","Included","auto","No","0","116451","790597","3449","910497","0.36"
"2025-10-22T15:24:34.128Z","Errored, Not Charged","auto","No","0","137727","2703230","3558","2844515","0.87"
"2025-10-22T15:19:14.215Z","Included","auto","No","0","39607","1573644","3346","1616597","0.46"
"2025-10-22T15:18:38.720Z","Included","auto","No","0","9517","199237","219","208973","0.06"
"2025-10-22T15:17:33.326Z","Included","auto","No","0","24151","183421","437","208009","0.08"
"2025-10-22T15:12:43.793Z","Included","auto","No","0","29317","377581","2405","409303","0.15"
"2025-10-22T15:08:50.225Z","Included","auto","No","0","16817","375588","2129","394534","0.13"
"2025-10-22T15:06:28.046Z","Included","auto","No","0","35025","66966","1998","103989","0.07"
"2025-10-22T15:00:29.929Z","Included","auto","No","0","70005","482323","3223","555551","0.23"
"2025-10-22T14:53:34.638Z","Included","auto","No","0","48351","59239","1633","109223","0.09"
"2025-10-22T14:49:40.793Z","Included","auto","No","0","56415","637994","4879","699288","0.26"
"2025-10-22T14:39:29.477Z","Included","auto","No","0","45021","611278","4684","660983","0.24"
"2025-10-22T14:39:19.143Z","Included","auto","No","0","0","0","0","0","0.00"
"2025-10-22T14:29:07.844Z","Errored, Not Charged","auto","No","0","77535","4648446","8321","4734302","1.31"
"2025-10-22T14:27:53.956Z","Included","auto","No","0","60092","443253","395","503740","0.19"
"2025-10-22T14:20:13.685Z","Included","auto","No","0","93210","596912","803","690925","0.27"
"2025-10-22T13:47:56.218Z","Included","auto","No","0","76308","1473643","2275","1552226","0.48"
"2025-10-22T13:47:04.444Z","Included","auto","No","0","9274","173422","266","182962","0.06"
"2025-10-22T13:46:01.577Z","Included","auto","No","0","7182","262097","385","269664","0.08"
"2025-10-22T13:44:52.701Z","Included","auto","No","0","43588","46593","390","90571","0.07"
"2025-10-22T13:38:27.844Z","Included","auto","No","0","156599","351264","1600","509463","0.29"
"2025-10-22T13:20:00.326Z","Included","auto","No","0","115005","428869","1655","545529","0.26"
"2025-10-22T13:02:47.884Z","Errored, Not Charged","auto","No","0","196179","5771390","12231","5979800","1.76"
"2025-10-22T12:43:23.321Z","Included","auto","No","0","110773","122686","125","233584","0.17"
"2025-10-22T12:29:40.332Z","Errored, Not Charged","auto","No","0","102082","1249110","1088","1352280","0.45"
"2025-10-22T12:19:30.205Z","Included","auto","No","0","82915","1463999","2238","1549152","0.48"
"2025-10-22T12:14:47.149Z","Errored, Not Charged","auto","No","0","90105","616382","830","707317","0.27"
"2025-10-22T12:10:35.329Z","Errored, Not Charged","auto","No","0","92512","587752","790","681054","0.27"
"2025-10-22T11:59:08.436Z","Included","auto","No","0","77517","324302","378","402197","0.18"
"2025-10-22T11:45:40.655Z","Included","auto","No","0","77603","720376","937","798916","0.28"
"2025-10-22T11:39:25.603Z","Included","auto","No","0","143371","3556710","4989","3705070","1.10"
"2025-10-22T11:30:54.016Z","Included","auto","No","0","120405","1377821","2308","1500534","0.51"
"2025-10-22T11:24:37.391Z","Errored, Not Charged","auto","No","0","107491","533846","1450","642787","0.28"
"2025-10-22T11:22:10.529Z","Errored, Not Charged","auto","No","0","92144","8361","385","100890","0.12"
"2025-10-22T11:14:45.994Z","Errored, Not Charged","auto","No","0","172962","1617712","5389","1796063","0.65"
"2025-10-22T11:01:38.163Z","Errored, Not Charged","auto","No","0","131203","2597438","4932","2733573","0.84"
"2025-10-22T10:59:56.788Z","Included","auto","No","0","802","1217","18","2037","0.001"
"2025-10-22T10:48:13.237Z","Included","auto","No","0","201131","2721983","8991","2932105","0.99"
"2025-10-22T10:40:36.305Z","Included","auto","No","0","174204","928980","25316","1128500","0.60"
"2025-10-22T10:31:38.436Z","Included","auto","No","0","101341","433660","632","535633","0.24"
"2025-10-22T10:19:35.029Z","Errored, Not Charged","auto","No","0","92986","1581859","2680","1677525","0.53"
"2025-10-22T10:09:20.700Z","Included","auto","No","0","97638","5266348","7843","5371829","1.49"
"2025-10-22T10:00:39.794Z","Included","auto","No","0","298020","3139702","24028","3461750","1.30"
"2025-10-22T09:40:40.333Z","Included","auto","No","0","57668","1363901","4612","1426181","0.44"
"2025-10-22T09:40:12.289Z","Included","auto","No","0","64508","39813","537","104858","0.09"
"2025-10-22T09:25:06.453Z","Included","auto","No","0","481415","1111928","42629","1635972","1.14"
"2025-10-22T09:24:50.647Z","Included","auto","No","0","0","0","0","0","0.00"
"2025-10-22T09:13:45.110Z","Included","auto","No","0","172293","736317","5650","914260","0.43"
"2025-10-22T09:13:26.451Z","Included","auto","No","0","85705","8532","279","94516","0.11"
"2025-10-22T08:50:35.173Z","Included","auto","No","0","182493","560543","15153","758189","0.46"
"2025-10-22T08:42:47.369Z","Errored, Not Charged","auto","No","0","112777","9073","620","122470","0.15"
"2025-10-22T08:34:50.577Z","Included","auto","No","0","202772","3427631","9851","3640254","1.17"
"2025-10-22T08:24:10.165Z","Errored, Not Charged","auto","No","0","224691","140531","28380","393602","0.49"
"2025-10-22T08:20:29.507Z","Included","auto","No","0","95615","1584130","9901","1689646","0.57"
"2025-10-22T08:15:44.211Z","Errored, Not Charged","auto","No","0","104798","9081","513","114392","0.14"
"2025-10-22T08:10:58.500Z","Included","auto","No","0","54124","2026069","3158","2083351","0.59"
"2025-10-22T08:05:42.983Z","Included","auto","No","0","59270","614249","1516","675035","0.24"
"2025-10-22T08:02:10.295Z","Included","auto","No","0","179694","1792511","15696","1987901","0.77"
"2025-10-22T07:55:02.956Z","Included","auto","No","0","77111","666391","5188","748690","0.29"
"2025-10-22T07:49:39.274Z","Included","auto","No","0","101809","663334","1431","766574","0.30"
"2025-10-22T07:44:36.157Z","Included","auto","No","0","74108","490642","2160","566910","0.23"
"2025-10-22T07:38:45.409Z","Included","auto","No","0","193774","1824857","17998","2036629","0.81"
"2025-10-22T07:35:15.113Z","Included","auto","No","0","121876","1372075","2085","1496036","0.51"
"2025-10-22T07:31:03.419Z","Included","auto","No","0","144458","16550","822","161830","0.19"
"2025-10-22T06:14:30.025Z","Errored, Not Charged","auto","No","0","472570","827494","50911","1350975","1.10"
"2025-10-22T06:06:05.260Z","Errored, Not Charged","auto","No","0","243461","2300797","6085","2550343","0.92"
"2025-10-22T06:02:07.513Z","Included","auto","No","0","243817","959167","3224","1206208","0.56"
"2025-10-22T05:57:42.504Z","Errored, Not Charged","auto","No","0","395001","536221","1089","932311","0.63"
"2025-10-22T05:51:51.592Z","Errored, Not Charged","auto","No","0","320763","824368","1162","1146293","0.61"
"2025-10-22T05:47:56.897Z","Errored, Not Charged","auto","No","0","310097","1132018","2203","1444318","0.68"
"2025-10-22T05:43:26.124Z","Errored, Not Charged","auto","No","0","313412","1018752","3393","1335557","0.67"
"2025-10-22T05:38:26.090Z","Errored, Not Charged","auto","No","0","323345","827340","2414","1153099","0.63"
"2025-10-22T05:32:55.489Z","Errored, Not Charged","auto","No","0","304615","1390866","1971","1697452","0.74"
"2025-10-22T05:28:32.617Z","Included","auto","No","0","378852","777357","25618","1181827","0.82"
"2025-10-22T05:24:44.351Z","Included","auto","No","0","374134","642869","24965","1041968","0.78"
"2025-10-22T05:20:12.168Z","Included","auto","No","0","330736","679170","24184","1034090","0.73"
"2025-10-22T05:18:09.940Z","Included","auto","No","0","80722","874314","2497","957533","0.33"
